phew	â˜‘ï¸
sign of the horns	ğŸŒ
alarm clock	ğŸŒ
home	ğŸŒ
pig head	ğŸŒ
flag for belarus	ğŸŒ
cloud with lightning	ğŸŒ
saxophone	ğŸŒ
gyrocopter	ğŸŒ
curly page	ğŸŒ
stars	ğŸŒ
black rightwards arrow	ğŸŒ
input symbol for latin letters	ğŸŒ
goofy	ğŸŒ
muscle	ğŸŒ
bone	ğŸŒ
regional indicator symbol letters za	ğŸ‡§ğŸ‡¾
purchase	ğŸ‡§ğŸ‡¾
keycap number sign	ğŸ‡§ğŸ‡¾
winter	ğŸ©
royal	ğŸ©
pot	ğŸ©
sunshine	ğŸ©
regional indicator symbol letters ar	ğŸ©
french kiss	ğŸ©
moyai	ğŸ©
meat on bone	ğŸ©
playing	ğŸ©
oxen	âœ‚ï¸
carousel horse	âœ‚ï¸
service	â¸
music	ğŸš´ğŸ¼
black large square	â™ï¸
constellation	â™ï¸
chilly	â™ï¸
engine	â™ï¸
cross eyes face	â™ï¸
red mask	â™ï¸
italian	â™ï¸
bathroom	â™ï¸
glower	â™ï¸
fancy	ğŸš¢
follower	ğŸš¢
flag for united arab emirates	ğŸš¢
light	ğŸš¢
rosary beads	ğŸš¢
celebrate	ğŸŒ½
morning	ğŸŒ½
eight pointed black star	ğŸŒ½
sign	ğŸŒ½
leaf fluttering in wind	ğŸŒ½
electric plug	ğŸŒ½
extraterrestrial alien	ğŸŒ½
exhausted	ğŸŒ½
hops	ğŸŒ½
unamused	ğŸŒ½
regional indicator symbol letters vc	ğŸŒ½
rice ball	ğŸŒ½
shape	ğŸŒ½
church	ğŸš‚
dragon	ğŸš‚
kissing lips	ğŸš‚
banknote with dollar sign	ğŸš‚
carnival	ğŸš‚
drooping flower	ğŸš‚
birthday	ğŸš‚
slalom	ğŸ‡®ğŸ‡´
wave	ğŸ‡®ğŸ‡´
desktop computer	ğŸ…¾ï¸
small	ğŸ›€ğŸ¼
teacher	ğŸ‡©ğŸ‡°
flag in hole	ğŸ‡©ğŸ‡°
x arms	ğŸŒ®
kiss with two women	ğŸ‡·ğŸ‡¼
impartial	ğŸ‡·ğŸ‡¼
regional indicator symbol letters kz	ğŸš“
card file box	ğŸš“
star	ğŸš“
iwazaru	ğŸš“
rolodex	ğŸš“
sleeping accommodation	ğŸš“
sun	ğŸš“
silent mode	ğŸš“
rock on	ğŸš“
sadface	ğŸš“
car	ğŸš“
wallet	ğŸ—
lather	ğŸ—
heart face	ğŸ—
speaker with three sound waves	ğŸ—
raccoon	ğŸ—
black person bowing deeply	ğŸ—
thought bubble	ğŸ—
answering question	ğŸ‘©
sky	ğŸ‘©
waning	ğŸ‘©
french horn	ğŸ‘©
endearment	ğŸ‘®ğŸ¾
cloud with snow	ğŸ’–
taxicab	ğŸ’–
regional indicator symbol letters ec	ğŸ’–
flag for iraq	ğŸ’–
light brown person with pouting face	ğŸ¤˜
chart with downwards trend	ğŸ¤˜
cloud with rain	ğŸ¤˜
oden	ğŸ¤˜
white white down pointing backhand index	ğŸ”·
dessert	ğŸŒ
game	ğŸŒ
transportation	ğŸŒ
hot	ğŸŒ
money	ğŸ›…
sisters	ğŸ›…
lame	ğŸ›…
restroom	ğŸ›…
red circle	ğŸ›…
no one under eighteen symbol	â–
smiling	â˜ƒ
birthday present	â˜ƒ
stave	ğŸ‘©â€â¤ï¸â€ğŸ‘©
disapproval	ğŸˆ¹
boat	ğŸˆ¹
horns	ğŸ˜š
cheeky monkey	ğŸ˜š
direct hit	ğŸ˜š
herb	ğŸ˜š
wonder	ğŸ˜š
black sun with rays	ğŸ˜š
open book	ğŸ˜š
dumplings and moon	ğŸ˜š
flag for guernsey	ğŸ˜š
blowfish	ğŸ˜š
regional indicator symbol letters th	ğŸ‡²ğŸ‡¾
kiss with two men	ğŸ‡²ğŸ‡¾
heavy large circle	ğŸ‡²ğŸ‡¾
cheese	ğŸ“ˆ
cranky	ğŸŒ˜
astrology	ğŸŒ˜
gay men	ğŸŒ˜
disappointed	ğŸŒ˜
brilliance	ğŸŒ˜
snapstreak	ğŸŒ˜
city	ğŸŒ˜
emperor	ğŸŒ˜
dairy	â›ºï¸
theater	ğŸ¥¡
boat	ğŸ‡¸ğŸ‡¹
ferris wheel	ğŸ‡¦ğŸ‡·
pointing down	ğŸ‡¦ğŸ‡·
lower left crayon	ğŸ‡¹ğŸ‡«
cosmonaut	ğŸ‡¹ğŸ‡«
small	ğŸ‡¹ğŸ‡«
water fountain	ğŸ––ğŸ¿
balloon	ğŸ¾
light brown dancer	ğŸ¾
lady	ğŸ¾
magnifier	ğŸ¾
open file folder	ğŸ¾
casserole	ğŸ¾
banned	ğŸ¾
new york	ğŸ¾
regional indicator symbol letters gb	ğŸ¾
tasty	ğŸ¾
financial	ğŸ¾
icecream	ğŸ¾
satellite	ğŸ¾
flag for gabon	ğŸ¾
downhill	ğŸ¾
money bag	ğŸ¾
pork	ğŸ¾
celebration	ğŸ¾
regional indicator symbol letters gn	ğŸ¾
turkish flag	ğŸˆ
tar	ğŸˆ
church building	ğŸˆ
art	ğŸˆ
black construction worker	ğŸˆ
tiredness	ğŸˆ
constellation	ğŸˆ
rhinoceros	ğŸˆ
shrugging	3ï¸âƒ£
check	ğŸ™…ğŸ½
anguish	ğŸ‘‰
horizontal	ğŸ‘‰
wink	ğŸ‘¨â€ğŸ‘¨â€ğŸ‘§â€ğŸ‘¦
regional indicator symbol letters kn	ğŸ¤¥
asian man	ğŸ¤¥
flock	ğŸ¤¥
slice of pizza	ğŸ¤¥
astonished face	ğŸ—“
pink flower	ğŸ•—
chains	ğŸ˜µ
hundred points symbol	ğŸ˜µ
articulated lorry	ğŸ˜µ
trust	ğŸ˜µ
potable	ğŸ˜µ
caution	ğŸ˜µ
nut	ğŸ‘
green book	ğŸ‘
flag for south korea	ğŸ‘
study	ğŸ‡¬ğŸ‡·
black face with no good gesture	ğŸ‡¬ğŸ‡·
year of the horse	ğŸ‡µğŸ‡°
green	ğŸ‡µğŸ‡°
wardrobe	ğŸ‡µğŸ‡°
icecream	ğŸ”¦
desert	ğŸ”¦
automobile	ğŸ”¦
smith	ğŸ›
purple crystal	ğŸ‘³ğŸ»
bow	ğŸ½
regional indicator symbol letters eg	ğŸ™‚
wireless	ğŸ™‚
chime	ğŸ‡¸ğŸ‡´
cheese	ğŸ‡¸ğŸ‡´
boy	ğŸ‡ºğŸ‡¸
bedroom	ğŸ‡ºğŸ‡¸
deeper brown happy person raising one hand	ğŸ‡ºğŸ‡¸
sars	ğŸ‡ºğŸ‡¸
sulk	ğŸ™‡ğŸ¼
iraqi flag	ğŸ´
big top	ğŸ´
clef	ğŸ´
sassy girl	ğŸ´
mongolian flag	ğŸ´
regional indicator symbol letters mk	ğŸ´
planets	ğŸ´
pink white green balls	ğŸ´
business shirt	ğŸ´
deeper brown guardsman	ğŸ´
door	ğŸ´
dog	ğŸ´
regional indicator symbol letters sr	ğŸ‡¹ğŸ‡²
bowing man	ğŸ‡¹ğŸ‡²
cob	â›„
dessert	â›„
raised back of hand	â›„
olive toned person with pouting face	â›„
movie camera	ğŸ‘ğŸ¿
no	â†©ï¸
german flag	ğŸš
djibouti flag	ğŸš
okay	ğŸš
black baby	ğŸš
arrow pointing rightwards then curving downwards	ğŸš
family of two men with one girl	ğŸŒ¸
deeper brown raised fist	ğŸŒ¸
dessert	ğŸŒ¸
vexed	ğŸŒ¸
weary face	ğŸŒ¸
constellation	ğŸŒ¸
cash	ğŸŒ¸
olive toned ok hand sign	ğŸ‘†ğŸ¿
stars	ğŸ™ğŸ¾
regional indicator symbol letters ro	ğŸ¦
åˆ	ğŸ¦
star	ğŸ¦
trousers	ğŸ’‚ğŸ½
police	ğŸš¯
banknote	ğŸš¯
hocho	ğŸš¯
ear of maize	ğŸš¯
sports medal	ğŸš¯
night	ğŸš¯
moisture	ğŸš¯
four leaf clover	ğŸ’‰
light brown person raising both hands in celebration	ğŸ’‰
sunnies	ğŸ’‰
agreement	ğŸ’‰
sow	ğŸ’‰
dark sunglasses	âœŠğŸ¿
festival	âš¾
hotel	âš¾
face with cold sweat	ğŸ‘‚ğŸ¼
medium white circle	ğŸ‘¨â€ğŸ‘©â€ğŸ‘§â€ğŸ‘§
peach	ğŸ‘¦ğŸ¼
red heart	Â©ï¸
beetle	ğŸ
north pole	ğŸ
mecca	ğŸ‘°ğŸ¿
six pointed star with middle dot	ğŸ‡§ğŸ‡³
face palm	ğŸ‡§ğŸ‡³
noodles	ğŸ‡§ğŸ‡³
å–¶	â„¹ï¸
rain	â„¹ï¸
zodiac	â„¹ï¸
wedding	â„¹ï¸
flag for venezuela	â„¹ï¸
automobile	ğŸ‘´ğŸ¼
waves	ğŸ·
flag for great britain	ğŸ·
sky	ğŸ·
flag in hole	ğŸ·
packing	ğŸ·
flag for papua new guinea	ğŸ·
hat	ğŸ·
fry	ğŸ·
kenyan flag	ğŸ·
flag for bahamas	ğŸ·
climax	ğŸš¾
flag for djibouti	ğŸš¾
flag for colombia	ğŸš¾
shipyard	ğŸš¾
tofu on fire	ğŸš¾
older woman	ğŸš¾
snowman	ğŸš¾
woman	ğŸš¾
bowl of rice	ğŸš¾
beauty	ğŸš¾
breakfast	ğŸš¾
open mouth	ğŸš¾
wine glass	âœ¡
couple	ğŸ“š
sauce	ğŸ“š
collision	ğŸ“š
laughing cat	ğŸ˜³
cute	ğŸ˜³
chestnut	ğŸ˜³
crop	ğŸ˜³
horns	ğŸ˜³
sign	ğŸ˜³
flag for czech republic	ğŸ˜³
blood type ab	ğŸ˜³
soup	ğŸ˜³
dropped pin	ğŸ¤§
prolific	ğŸ‘ŠğŸ¿
zodiac	âœ’ï¸
regional indicator symbol letters tc	â™ˆï¸
cherry blossom	â™ˆï¸
gamble	â™ˆï¸
banknote with pound sign	â™ˆï¸
sign	â™ˆï¸
womens toilet	â™ˆï¸
sugar	â™ˆï¸
vision	â™ˆï¸
moisture	ğŸ’º
frying pan	ğŸ›
party	ğŸ›
cracker	ğŸ—º
theme park	ğŸƒ
machine	ğŸƒ
squared cl	ğŸƒ
levi	ğŸ’°
entrance	ğŸ’°
tram	ğŸ’°
deeper brown nail polish	â˜”ï¸
falklander flag	ğŸ‘µğŸ¿
headphone	ğŸ’
italian flag	ğŸ’
multiple heart	ğŸ‡®ğŸ‡·
statue of liberty	ğŸ‡®ğŸ‡·
flag for european union	ğŸ‡²ğŸ‡¨
girl with tiara	ğŸŒ
love	ğŸŒ
flower	ğŸŒ
keycap digit one	ğŸŒ
devil	ğŸŒ
expressionless face	ğŸŒ
black heart	ğŸŒ
cold	ğŸŒ
olive toned white left pointing backhand index	ğŸŒ
dragon head	ğŸŒ
kids	ğŸŒ
tornado	ğŸ¤›
ribbon	â›º
japanese	â›º
high brightness symbol	ğŸ‘‹ğŸ¼
shopping	ğŸ–•
flag for guatemala	ğŸ–•
linked paperclips	ğŸ–•
pile	ğŸ–•
convenience store	ğŸ–•
kaaba	â€¼ï¸
regional indicator symbol letters pe	ğŸ‘ğŸ¼
android lollipop	ğŸ»
multiple	ğŸ»
impact	ğŸ»
porcelain	ğŸ»
heart	ğŸ»
loop	ğŸ»
skier	ğŸ»
hands	ğŸ»
adultery	ğŸ»
disapprove	ğŸ»
request	ğŸ»
search icon	ğŸ»
investigator	ğŸ‡¦ğŸ‡¨
black raised hand	ğŸ‘¼ğŸ½
family of a man and woman with one girl	ğŸ‘©ğŸ½
blood test	ğŸ·
deeper brown flexed biceps	ğŸ‡µğŸ‡­
otsukimi	ğŸ‡µğŸ‡­
years	ğŸ“º
regional indicator symbol letters fr	ğŸ“º
round pushpin	â—€ï¸
cruise	ğŸ½
face savouring delicious food	ğŸ½
engagement ring	ğŸ½
frustrated	ğŸ½
wrench	ğŸ½
flag for central african republic	ğŸ½
regional indicator symbol letters jp	ğŸ½
christmas	ğŸ½
regional indicator symbol letters bo	ğŸ½
instrument	ğŸ‘¨â€ğŸ‘¨â€ğŸ‘¦â€ğŸ‘¦
food	ğŸŒ‘
gift heart	ğŸŒ‘
black princess	ğŸŒ‘
daughter	ğŸŒ‘
gear	ğŸŒ‘
warm	ğŸŒ‘
buffalo	ğŸŒ‘
baby	ğŸŒ‘
world wide web	ğŸŒ‘
squared id	ğŸŒ‘
brokenhearted	â™¿
triangular ruler	â™¿
canada	ğŸ›
ski	ğŸ›
wedding	ğŸ›
coconut tree	ğŸ›
unlock	ğŸ›
constellation	ğŸ›
eyebrow sweat	ğŸ›
front of car	ğŸ—
octopus	âŒ¨
tennis ball	ğŸ‡¨ğŸ‡¿
cutlery	ğŸ‡¨ğŸ‡¿
twins	ğŸ‡³ğŸ‡®
coach	ğŸ‡³ğŸ‡®
french guinean flag	â¡ï¸
rowing	ğŸ®
synagog	ğŸ®
railway	ğŸ®
menorah	ğŸ®
wisdom	ğŸ®
spiral shell	ğŸ®
fungus	ğŸ®
basketball and hoop	ğŸ®
walk	ğŸ®
one hundred	ğŸ®
happy face	âš ï¸
fish	ğŸ‘ŒğŸ½
scared cat	â™‰
shampoo	â™‰
regional indicator symbol letters mw	â™‰
sniffing	â™‰
gemini	â™‰
automated teller machine	â™‰
nervous face	â™‰
curry and rice	â™‰
racing motorcycle	ğŸ“¹
sound	ğŸ“¹
squared new	ğŸ‡¸ğŸ‡½
sparkly heart	ğŸ‡¸ğŸ‡½
flavoring	â›©
rice	ğŸ‡¬ğŸ‡¬
waving black flag	ğŸ‘ğŸ½
motor cycle	ğŸš¥
hugging face	ğŸš¥
lamb	ğŸš¥
myth	ğŸš¥
smiling poop	ğŸš¥
adam	ğŸš¥
flag for jordan	ğŸš¥
silent	ğŸš¥
fork	ğŸ…ğŸ½
world	ğŸˆµ
capricorn	ğŸˆµ
angel	ğŸ˜–
â„¹ lowercase i	ğŸ˜–
mushroom	ğŸ˜–
place of worship	ğŸ˜–
clock face two oclock	ğŸ˜–
queen	ğŸ˜–
nails	ğŸ˜–
cry	ğŸ˜–
contacts	ğŸ‘±ğŸ¿
wii u	ğŸ†”
police car	ğŸ†”
cold	ğŸ†”
regional indicator symbol letters br	ğŸ•µ
words	ğŸ•µ
deeper brown swimmer	ğŸ•µ
map pin	ğŸ•µ
flag for kosovo	ğŸ•µ
constellation	ğŸ¥–
ice	â—½ï¸
pointing right	ğŸ˜¹
honey pot	ğŸ˜¹
emergency	ğŸ˜¹
cherry blossom	ğŸ˜¹
downwards black arrow	ğŸ˜¹
flag for macau	ğŸ˜¹
flag for swaziland	ğŸ˜¹
regional indicator symbol letters py	ğŸ´
celebration	ğŸ´
cash	ğŸ´
flag for guyana	ğŸ´
ok	ğŸ´
regional indicator symbol letters as	ğŸ´
regional indicator symbol letter z	ğŸ´
underground	ğŸ´
constellation	ğŸ´
middle school	â˜®
handshake	â˜®
distress	ğŸ‡¨ğŸ‡´
fluttering	ğŸ‡¨ğŸ‡´
white woman	ğŸŒ¤
disney	ğŸ”ˆ
regional indicator symbol letters af	ğŸ”ˆ
shop	ğŸ‘³ğŸ¿
toilet	ğŸ‡¸ğŸ‡°
astrology	ğŸ‡¸ğŸ‡°
batman	ğŸ‘
waving hand sign	ğŸ‘
identification	ğŸ‘
granny smith apple	ğŸ‘
flag for falkland islands	ğŸ‘
ice	ğŸ‘
ç¦	ğŸ‘
clipboard	ğŸ¤¡
flag for montenegro	ğŸ¤¡
wedding	ğŸ‡³ğŸ‡¿
basin	ğŸ‡³ğŸ‡¿
white baby	ğŸ‡³ğŸ‡¿
massaging	ğŸ˜¾
collision symbol	ğŸ˜¾
blubber	ğŸ˜¾
woman	ğŸ˜¾
red pin	ğŸ˜¾
sign	ğŸ˜¾
field hockey stick and ball	ğŸ˜¾
woot	ğŸš¹
dessert	ğŸš¹
pine tree	ğŸš¹
fist pump	ğŸš¹
thinker	ğŸš¹
note	ğŸš¹
see	ğŸš¹
black medium square	ğŸš¹
leopard	ğŸš¹
fruit	ğŸš¹
wine	ğŸ†–
white thumbs down sign	ğŸ†–
winter	ğŸ†–
custard	ğŸ†–
block of chocolate	ğŸ•·
veteran	ğŸ¥˜
greek	ğŸ”
sky	ğŸ”
patrick	ğŸ”
hot beverage	ğŸ”
children	ğŸ”
light brown bicyclist	ğŸ”
globe	ğŸ„ğŸ¾
black man with gua pi mao	ğŸ‡²ğŸ‡­
yield	ğŸ‡²ğŸ‡­
moon	ğŸ‡±ğŸ‡¦
ballot box with ballot	ğŸ‡±ğŸ‡¦
tense	ğŸšµğŸ¼
reminder ribbon	ğŸ›¥
pointing left	ğŸŒ„
emergency	ğŸŒ„
hot	ğŸŒ„
barbadian flag	ğŸŒ„
food	ğŸŒ„
double exclamation mark	ğŸŒ„
bicyclist	ğŸŒ„
government	ğŸŒ„
face	ğŸ‡µ
win	ğŸ’ğŸ¿
car	ğŸš™
clairvoyant	ğŸš™
red	ğŸš™
crosswalk	ğŸš™
myself	ğŸš™
fairground	ğŸš™
white runner	ğŸš™
white medium small square	ğŸš™
snow	ğŸšª
constellation	ğŸšª
japanese	ğŸšª
train	ğŸšª
flag for rwanda	ğŸšª
military medal	ğŸšª
astrology	ğŸšª
regional indicator symbol letters fi	ğŸ’…ğŸ½
white	ğŸ•š
pile of books	ğŸ¦Š
tired	ğŸ¦Š
me	âœŠ
astrology	âœŠ
circled ideograph advantage	â—
love	ğŸ’
bed	ğŸ’
restroom	ğŸ’
venezuelan flag	ğŸš†
tee shirt	ğŸš†
clammy	ğŸš†
full	ğŸš†
toadfish	ğŸš†
european post office	ğŸš†
home alone	ğŸš†
sad person	ğŸ‡®ğŸ‡ª
greek	ğŸ‡®ğŸ‡ª
ac adaptor	ğŸ‡®ğŸ‡ª
fire tag	ğŸ‡²ğŸ‡·
couple with heart	ğŸ‡²ğŸ‡·
sky	ğŸ’
sugar	ğŸ’
water	ğŸ’
performing	ğŸ’
bullet train	ğŸ’
kawaii	ğŸ‡ğŸ¼
clothing	ğŸ™
algerian flag	ğŸ™
asian camel	ğŸ™
honey	ğŸ™
celebration	ğŸ™
white medium star	ğŸ™
railway locomotive	ğŸ™
serious	ğŸ™
candy	ğŸ™
idea	ğŸ™
regional indicator symbol letters tt	ğŸ‡ºğŸ‡¬
mother christmas	ğŸ‡ºğŸ‡¬
petals	â›³
black ok hand sign	â›³
drink	â›³
study	ğŸ“
crescent	ğŸ‡§ğŸ‡¯
science	ğŸ‡§ğŸ‡¯
sign	ğŸ‡§ğŸ‡¯
grey rat	ğŸ”™
new moon with face	ğŸ”™
name tag	âœ‹ğŸ»
regional indicator symbol letters tj	ğŸ†™
flag for egypt	ğŸ†™
bus	ğŸ†™
worried	ğŸ•º
compassionate	ğŸ•º
dark	ğŸ•º
red monster	ğŸ‡µğŸ‡¾
smooch	ğŸ‡µğŸ‡¾
horse	î”Š
chinese	î”Š
flag for yemen	î”Š
cake	î”Š
doctor	ğŸŒ±
dessert	ğŸŒ±
flashing light	ğŸŒ±
green	ğŸŒ±
regional indicator symbol letters hu	ğŸŒ±
shew stone	ğŸŒ±
foggy	ğŸŒ±
watch	ğŸŒ±
light brown white left pointing backhand index	ğŸ˜¯
crying cat face	ğŸ˜¯
mummy	ğŸ˜¯
speech balloon	ğŸ˜¯
acoustic guitar	ğŸ˜¯
wash	ğŸ˜¯
silent	ğŸ˜¯
globe with meridians	ğŸ‡¹ğŸ‡¦
anxious	ğŸ—³
flag for clipperton island	ğŸ‡ªğŸ‡¸
tears	ğŸ‡ªğŸ‡¸
black horse racing	ğŸ‡ªğŸ‡¸
smooth	ğŸ—
us virgin islander flag	ğŸ‘°ğŸ»
sauce	ğŸŠğŸ¿
lock with ink pen	ğŸ“¨
bowling ball	ğŸ“¨
closed mailbox with lowered flag	ğŸ“¨
puffer	ğŸ‡²ğŸ‡ª
flag for costa rica	ğŸ‡²ğŸ‡ª
vapid	ğŸ
cantaloupe	ğŸ
woman with bunny ears	ğŸ
evening	ğŸ
taste	ğŸ
face with open mouth	ğŸ
flag for rÃ©union	ğŸ
olive toned open hands sign	ğŸ
exclamation question mark	ğŸ
aqua	ğŸ
calendar	ğŸ
stars	ğŸ
stars	ğŸ
pc tower	ğŸ
lorry	ğŸ
volleyball	ğŸ»
flag for british indian ocean territory	ğŸ»
leaf	ğŸ»
deeper brown open hands sign	ğŸ»
palm	ğŸ»
gherkin	ğŸ¡
drop	ğŸ¡
deeper brown person with pouting face	ğŸ°
sobbing	ğŸ°
regional indicator symbol letters hr	ğŸ°
instrument	ğŸ°
heart	ğŸ™Š
packing	ğŸ™Š
snowman without snow	ğŸ™Š
volume	ğŸ™Š
bactrian camel	ğŸ™Š
beer stein	ğŸ™Š
tears	ğŸ™Š
flag for chad	ğŸ™Š
copyright sign	ğŸ™Š
monster	ğŸ™Š
white white right pointing backhand index	ğŸ™Š
drunk	ğŸ“
two hands	ğŸ“
formula one	ğŸ“
stars	ğŸ“
quarter	ğŸ“
holiday	ğŸŒ’
kitten	ğŸŒ’
diamond	ğŸŒ’
sad	ğŸŒ’
crystal	ğŸŒ’
recreational vehicle	ğŸŒ’
olive toned rowboat	ğŸŒ’
race	ğŸ›³
polo shirt	ğŸ
astrology	ğŸ
customs	ğŸ
astrology	ğŸ’¡
regional indicator symbol letters bb	ğŸ’¡
archer	ğŸ’¡
cat	ğŸ’¡
human rock carving	ğŸ’¡
tulip	â›µï¸
end	ğŸ•‰
mountain	ğŸ•‰
rabbit face	ğŸ•‰
sailor	ğŸ•‰
flag for japan	âœ…
passport	âœ…
details	âœ…
applause	âœ…
baby change station	ğŸ‡²ğŸ‡»
olive toned man with turban	ğŸ‡²ğŸ‡»
marina	ğŸ¢
large orange diamond	ğŸ¢
motor	ğŸ¢
fugu fish	ğŸ¢
light brown person frowning	ğŸ¢
filly	ğŸ¢
comic	ğŸ¢
frying	ğŸ¢
ride	ğŸ‡·ğŸ‡´
king	ğŸ‡·ğŸ‡´
empty bathtub	ğŸ‡ªğŸ‡ª
diversity	ğŸ‡ªğŸ‡ª
frozen	ğŸ‡ªğŸ‡ª
heart above dot	ğŸ‘º
cold	ğŸ‘º
train platform	ğŸ‘º
ogre	ğŸ‘º
regional indicator symbol letters bg	ğŸ‘º
paper	ğŸ‘º
babe	ğŸ‘º
clock face three oclock	ğŸ‘º
snoring	ğŸ‘º
dizzy face	ğŸ‘º
score	ğŸ‘º
person frowning	ğŸ‘º
gift	ğŸ‘º
dessert stick	ğŸ‘º
flashlight	ğŸ‘º
regional indicator symbol letters zm	ğŸ‘º
holiday	ğŸ„ğŸ»
linked chain	â™ ï¸
place	â™ ï¸
sneaker	ğŸ¡
deeper brown boy	ğŸ¡
motorway	ğŸ¡
soup	ğŸ¡
fish	ğŸ¡
nose	ğŸ¡
tired	ğŸ¡
dollar	ğŸ¡
savoring	ğŸ¡
gold	ğŸ¡
left speech bubble	ğŸ¡
banknote with euro sign	ğŸ’ƒğŸ¾
heat	ğŸ‡¦ğŸ‡¼
phase	ğŸ‡¦ğŸ‡¼
rugby	ğŸˆ´
souvlaki	ğŸˆ´
cable	ğŸ˜•
flag for tokelau	ğŸ˜•
white large square	ğŸ˜•
flag for cook islands	ğŸ˜•
deeper brown rowboat	ğŸ˜•
flag for united states	ğŸ˜•
astrology	ğŸ˜•
british guardsman	ğŸ˜•
pound note	ğŸ“¶
bowl	ğŸ“¶
video	ğŸ“¶
blue	ğŸ“¶
acting	ğŸ’
achievement	ğŸ’
black	ğŸ’
strawberry shortcake	ğŸ’
bathroom	ğŸ’
blossom	ğŸ’
whale	ğŸ”
regional indicator symbol letters ss	ğŸ”
poker machine	ğŸ”
regional indicator symbol letters kr	ğŸ”
bouquet of flowers	ğŸ”
scorpio	ğŸ‡¸ğŸ‡ª
help	ğŸ‡¸ğŸ‡ª
no entry sign	ğŸˆ·ï¸
kiss face	ğŸˆ·ï¸
soap	ğŸ“­
love letter	ğŸ‘¦ğŸ»
two bump camel	ğŸ’‡ğŸ»
gifts	ğŸ
golden gate bridge	ğŸ
wool	ğŸ
light brown mountain bicyclist	ğŸ
helicopter	ğŸ
enthusiasm	ğŸ
drooling face	ğŸ
anchor	ğŸ
sob	ğŸ
complete	ğŸ
droplet	ğŸ
winking face	ğŸŒ…
softball	ğŸŒ…
gemini	ğŸŒ…
fish	ğŸŒ…
school crossing	ğŸŒ…
keycap digit three	ğŸŒ…
bang	ğŸ¤
color	ğŸ¤
love	ğŸ¤
concierge	ğŸ”¯
deeper brown older woman	ğŸ˜’
medical	ğŸ˜’
pencil	ğŸ˜’
instrument	ğŸ˜’
scream	ğŸ˜’
trash	ğŸ˜’
heterosexual couple	ğŸ˜’
notifications	ğŸ˜’
intimacy	ğŸ˜’
novel	ğŸ‘©ğŸ»
olive toned face massage	ğŸ‡¨ğŸ‡»
detail	ğŸ‡¨ğŸ‡»
tag	ğŸ›
revolver	ğŸ¯
red balloon	ğŸ¯
marijuana	ğŸ¯
film	ğŸ¯
constellation	ğŸ¯
grinning cat	ğŸ¯
heart	ğŸ¤°
note	ğŸ¤°
event	ğŸ¤°
new year decoration	ğŸ‡¦ğŸ‡±
smiley	ğŸ‡¦ğŸ‡±
asian	ğŸ²
sick	ğŸ²
checkered	ğŸ²
squirrel	ğŸ²
couple with heart with two men	ğŸ²
sorry	ğŸ²
heart	ğŸ²
ear of rice	ğŸ˜½
mouthless	ğŸ˜½
middle	ğŸ˜½
chamorro flag	ğŸ˜½
black spade suit	ğŸ˜½
stallion	ğŸ˜½
light	ğŸ˜½
floppy	ğŸ‡§ğŸ‡«
olive toned mountain bicyclist	ğŸ‡§ğŸ‡«
south	ğŸ‡¸ğŸ‡±
fronds	ğŸ‡¸ğŸ‡±
sick	ğŸ¨
left fist bump	ğŸ¨
sexy	ğŸ¨
mouse face	ğŸ¨
cityscape at dusk	ğŸ¨
spider web	ğŸ¨
fortress	ğŸ¨
mug	ğŸ¨
hatching chick	ğŸ¨
officer	ğŸ¨
womans clothes	ğŸ¨
bunny rabbit	ğŸ¨
regional indicator symbol letters bw	ğŸ’
tree	ğŸ’
halloween	ğŸ’
england	ğŸ’
relationship	ğŸ’
hot bath	ğŸ’
blouse	ğŸ’
dialogue	ğŸ’
keycap digit seven	ğŸ’
flag for iceland	ğŸ’
cute penguin	ğŸ’
water	ğŸ’
holiday	ğŸ’
lungs	ğŸ¦…
deeper brown face massage	ğŸ¦…
kissing face	ğŸ–¤
electric train	ğŸ–¤
bicycle	âœï¸
black mountain bicyclist	ğŸ“
leo	ğŸ“
flag for united kingdom	ğŸ™ğŸ½
running shirt with sash	â˜€ï¸
cable car	â˜€ï¸
regional indicator symbol letters ps	â˜€ï¸
hyperlink	â™
flag for benin	â™
pan	â™
insect	â™
popcorn	â™
flower	â™
waxing crescent moon symbol	â™
throne	â™
dutch flag	ğŸ
flag for philippines	ğŸ
face with look of triumph	ğŸ
grapes	ğŸ
curling loop	ğŸ
loyalty	ğŸ
camera	ğŸ
walt jabsco	ğŸ
sign	ğŸ
football	ğŸ
bike	ğŸ
picture frame	ğŸš”
lucky	ğŸš”
devil	ğŸš”
rip city	ğŸš”
new york	ğŸš”
work	ğŸš”
longevity	ğŸš”
indian	ğŸš”
high five	ğŸš”
traffic light	ğŸ’“
princess	ğŸ’“
kiss	ğŸ’“
transport	ğŸ’“
sunface	ğŸ‘±ğŸ»
bookmark tabs	ğŸ´
hourglass	ğŸ™‹ğŸ½
family	ğŸŒ 
chocolate cookie	ğŸŒ 
nipple	ğŸŒ 
wistful	ğŸŒ 
soap	ğŸŒ 
regional indicator symbol letters so	ğŸŒ 
biscuit	ğŸŒ 
camel	ğŸŒ 
europe	ğŸŒ 
candle	ğŸ––
olive toned baby	ğŸ––
compete	ğŸ––
food	ğŸ––
rain	ğŸ’…ğŸ¼
flag for indonesia	ğŸ‡¿ğŸ‡¼
spoon	ğŸ‡¿ğŸ‡¼
mouse	ğŸ‡³ğŸ‡«
dumpling	ğŸ‡³ğŸ‡«
happy cat	â¤ï¸
tent	â¤ï¸
cosmetic	â¤ï¸
young	â¤ï¸
quivering mouth	â¤ï¸
crying cat	â¤ï¸
walk	â¤ï¸
snitch	â¤ï¸
no speaking	â¤ï¸
finals	â¤ï¸
flag for serbia	â¤ï¸
ski	â¤ï¸
teeth	â¤ï¸
bathroom	â¤ï¸
wheel	â¤ï¸
lungs	ğŸ†’
accessible bathroom	ğŸ†’
regional indicator symbol letters ws	ğŸ¥”
chick	ğŸ¥”
flag for barbados	ğŸ¥”
spooky	ğŸ•³
astrology	ğŸ‘²ğŸ¾
eyesight	ğŸ˜£
flag for jersey	ğŸ˜£
silly	ğŸ˜£
flag for ukraine	ğŸ˜£
smile	ğŸ˜£
notebook with decorative cover	ğŸš…
deeper brown white right pointing backhand index	ğŸš…
road	ğŸš…
bamboo	ğŸš…
8 ball	ğŸš…
bus	â™ˆ
stability	â™ˆ
fast envelope	â™ˆ
side of taxi	â™ˆ
flag for french southern territories	â™ˆ
front of taxi	â™ˆ
horror	â™ˆ
mouth	â™ˆ
speaker	ğŸ‘³
feline	ğŸ‘³
constellation	ğŸ‘³
bargain sale	ğŸ‘³
spiral eyes face	ğŸ‘³
mouth	ğŸ‘³
couch	ğŸ‘³
black older man	ğŸ‘³
raw	ğŸ‘³
boogy	ğŸ‘³
african leopard	ğŸ‘³
bullet	ğŸ‘³
swiss flag	ğŸ‘³
british	ğŸ²
flag for denmark	ğŸ²
greek	ğŸ²
deeper brown haircut	ğŸ²
cuteness	ğŸ²
olive toned boy	ğŸ²
werewolves	ğŸ²
news	ğŸ²
confused face	ğŸ”
white clapping hands sign	ğŸ˜„
olive toned person frowning	ğŸ˜„
silhouette	ğŸ˜„
envelope with downwards arrow above	ğŸ˜„
badminton racquet and shuttlecock	ğŸ˜„
spiral	ğŸ˜„
olive toned man with gua pi mao	ğŸ˜„
bento box	ğŸš´ğŸ¿
water	ğŸ‘ŒğŸ¾
bull	ğŸ˜ª
girl with crown	ğŸ˜ª
japanese flag	ğŸ˜ª
father christmas	ğŸ˜ª
regional indicator symbol letters it	ğŸ˜ª
xbox	ğŸ‡²ğŸ‡©
french	ğŸ‡²ğŸ‡©
hump	ğŸ’ªğŸ»
jellyfish	ğŸ”©
vaccination	ğŸ”©
cheese	ğŸ”©
camera with flash	ğŸ‘
money	ğŸ‘
burned	ğŸš¦
spanish flag	ğŸš¦
leg	ğŸš¦
boo	ğŸš¦
zodiac	ğŸš¦
splayed hand	ğŸš¦
smh	ğŸš¦
oil drum	ğŸš¦
cheese	ğŸ‘†ğŸ½
solomon islander flag	ğŸ’ğŸ»
scary face	ğŸ’
water drop	ğŸ’
droplet	ğŸ™ŒğŸ¿
astrology	ğŸ‡¬ğŸ‡­
caymanian flag	ğŸ‡¬ğŸ‡­
hurt	ğŸ‡¬ğŸ‡­
dvd video	ğŸšŠ
keycap digit seven	ğŸšŠ
gibbous	ğŸšŠ
keycap digit five	ğŸ‡¶ğŸ‡¦
envious	ğŸ‡¶ğŸ‡¦
left right arrow	ğŸ‘°
rugby football	ğŸ‘°
treat	ğŸ‘°
suv	ğŸ‘°
flirt	ğŸ‘°
school	ğŸ‘°
weight lifter	ğŸ‘°
water wave	ğŸ‘°
director	ğŸ‘°
orthodox cross	ğŸ‘°
feet	ğŸ”
flag for guadeloupe	ğŸ”
lower left fountain pen	ğŸ”
blossoming flower	ğŸ”
japanese post office	ğŸ”
double vertical bar	ğŸ”
whistling	ğŸ”
snail	ğŸ‘³ğŸ¾
race	ğŸ
flag for north korea	ğŸ
flying money	ğŸ
border control	ğŸ
cross	ğŸ
painting	ğŸ
walker	ğŸ
bridge	ğŸ
face without mouth	ğŸ
papua new guinean flag	ğŸ
thoughtful	ğŸ
elementary	ğŸ
japanese	ğŸ
insert in envelope	ğŸ
police	ğŸ
white medium square	ğŸ
bug	ğŸ
clock face ten oclock	ğŸ
wagon	ğŸ
wind blowing face	ğŸ
miniature poodle	ğŸ
sleeping face	ğŸ
meal	ğŸ‘ğŸ¼
ireland	â—½
sweet	ğŸ†•
constellation	ğŸ†•
test	ğŸ¥—
steady	ğŸ•¶
doctor	ğŸ’†ğŸ¿
homework	ğŸ‡²ğŸ‡¶
h20	ğŸ‡²ğŸ‡¶
presents	ğŸ‡²ğŸ‡¶
japanese	ğŸ‡²ğŸ‡¶
flag for germany	ğŸ®
regional indicator symbol letters la	ğŸ®
scorpius	ğŸ®
torch	ğŸ®
fountain	ğŸ®
dollar	ğŸ®
check	ğŸ®
pile of poo	ğŸ®
flag for norfolk island	ğŸ®
halo	ğŸ®
robot face	ğŸ®
city	ğŸ®
day	ğŸ€
long nose face	ğŸ€
road	ğŸ€
funicular	ğŸ€
men	ğŸ€
closed mailbox with raised flag	ğŸ€
night sky	ğŸ€
baby	ğŸ€
no	ğŸ€
primary rainbow	ğŸ€
umbrella	ğŸ€
american samoan flag	ğŸ¶
spice	ğŸ¶
video tape	ğŸ¶
heavy black heart	ğŸŒ¥
score	ğŸšµğŸ¿
luggage	ğŸ‚
jog	ğŸ‚
flag for slovakia	ğŸ‚
cheeky	â™‹ï¸
typhoon	â™‹ï¸
pony	â™‹ï¸
light brown bath	â™‹ï¸
devil fingers	â™‹ï¸
circled ideograph congratulation	â™‹ï¸
bald eagle	â™‹ï¸
cream	â™‹ï¸
porcelain	ğŸ‘µğŸ¼
loving cat	ğŸ‘ğŸ¿
i	ğŸ·
olive toned waving hand sign	ğŸ·
birthday	ğŸ·
bridge at night	ğŸ·
package	ğŸ·
deeper brown face with ok gesture	ğŸ·
bouquet	ğŸ™‡ğŸ»
europe	ğŸ—¯
ball	ğŸ—¯
king	ğŸ’
cool square	ğŸ’
transportation	ğŸ’
card index	ğŸ’
greek	ğŸ’
astrology	ğŸ’
kissing face with smiling eyes	ğŸ’
error	ğŸ’
bbq	ğŸ’
tent	ğŸ’
racket	ğŸ’
anthropomorphic	ğŸ’
raised fist	ğŸ’
olive toned girl	ğŸ
baby chick	ğŸ’­
nori	ğŸ’­
putto	ğŸ’­
flag for san marino	ğŸ’­
lock with fountain pen	ğŸ’­
japanese	ğŸ’­
smirk	ğŸ’­
funeral	ğŸ’­
cooking	ğŸ’­
raise	ğŸ¡
cherry	ğŸ¡
astrology	ğŸ¡
string quartet	ğŸ¡
slop	ğŸ¡
family of two women with two girls	ğŸ¡
evil	ğŸ¡
toast	ğŸ¡
signature	ğŸ“¡
flag for luxembourg	ğŸ‡±ğŸ‡º
pig snout	ğŸ‡±ğŸ‡º
champagne glasses	ğŸ‘–
cat face	ğŸ‘–
oral	ğŸ‘–
laugh	ğŸ‘–
light brown raised fist	ğŸ‘–
cat	ğŸ‘–
night	ğŸ‘–
painting	ğŸ‘–
artist	ğŸ‘–
table tennis paddle and ball	ğŸš
man	ğŸš
bunny rabbit	ğŸš
accept	ğŸš
yeast	ğŸš
mountain cableway	ğŸš
plane	ğŸš
horizontal traffic light	ğŸš
chocolate box	ğŸ’š
sleepy	ğŸ’š
last	ğŸ’š
hard work	ğŸ’š
flag for ghana	ğŸ’š
bag	ğŸ’š
lightning bolt	ğŸ’š
bill	ğŸ’š
flushed face	ğŸ’š
timer clock	ğŸ’š
irate	ğŸ’š
gamble	ğŸ’š
sky	ğŸ™†ğŸ¿
smiley	ğŸ¤¦
moon	ğŸ¤¦
padlock	ğŸ¤¦
tablet	ğŸ¤¦
foot	ğŸ”–
motion	ğŸ”–
bento	ğŸ”–
japan	ğŸ‡°ğŸ‡¬
spot	ğŸ‡°ğŸ‡¬
regional indicator symbol letters si	ğŸ›¡
m	ğŸŒ€
family of two men with two girls	ğŸŒ€
regional indicator symbol letters nc	ğŸŒ€
score	ğŸŒ€
chipmunk	ğŸŒ€
stroll	ğŸŒ€
truck	ğŸŒ€
tongue	ğŸŒ€
tea	ğŸŒ€
deeper brown bicyclist	ğŸ‘©â€ğŸ‘©â€ğŸ‘§â€ğŸ‘¦
peel	ğŸ‡§ğŸ‡²
cheese	ğŸ‡§ğŸ‡²
dung	ğŸ‡§ğŸ‡²
construction	ğŸƒ
croissant	ğŸƒ
manx flag	ğŸƒ
human	ğŸƒ
homer	ğŸƒ
noodles	ğŸƒ
delicious	ğŸƒ
deeper brown pedestrian	ğŸƒ
shell	ğŸ“‰
gyro	ğŸ”
zodiac	ğŸ”
kissing	ğŸ‡³ğŸ‡¦
cone	ğŸ‡³ğŸ‡¦
monster	ğŸ³
diamond shape with a dot inside	ğŸ˜‰
travel	ğŸ˜‰
up	ğŸ˜‰
kiss	ğŸ˜‰
accounts	ğŸ˜‰
flag for tanzania	ğŸ˜‰
candles	ğŸ˜‰
children crossing	ğŸš¶ğŸ¼
freestyle	ğŸ‘¨ğŸ¿
crowing	ğŸ‘®ğŸ»
metro	ğŸ“°
radio button	ğŸ“°
joystick	ğŸ“°
package	ğŸ“°
call me hand	#ï¸âƒ£
fallen leaf	ğŸ
constellation	ğŸ
sound	ğŸ
dead	ğŸ
answer	ğŸ”¡
castle	ğŸ”¡
regional indicator symbol letters qa	ğŸ”¡
bird	ğŸš
topper	ğŸš
alcohol	ğŸš
reversed hand with middle finger extended	ğŸš
ophiuchus	ğŸš
scary clown	ğŸš
freestyle	ğŸš
light brown thumbs up sign	ğŸ˜´
emergency light	ğŸ˜´
regional indicator symbol letter j	ğŸ˜´
bottle feeding	ğŸ˜´
small orange diamond	ğŸ˜´
trash	ğŸ˜´
transport	ğŸ˜´
summer	ğŸ˜´
balloon	ğŸ—„
proof	â™“
pound	â™“
potable water symbol	â™“
smile	â™“
ranch	â™“
fair	â™“
beats	â™“
new	â™“
chinese camel	ğŸŠğŸ¼
degree	ğŸ™…
currency	ğŸ™…
fisherman	ğŸ™…
grinning cat face with smiling eyes	ğŸ™…
family of a man and woman with two girls	ğŸ™…
flipped	ğŸ™…
sunrise over mountains	ğŸ™…
moist	ğŸ”³
libra	ğŸ¤”
peace symbol	ğŸ¤”
watch	ğŸ‡®
waxing	ğŸ‘¶
input symbol for numbers	ğŸ‘¶
sleepy	ğŸ‘¶
squared katakana koko	ğŸ‘ğŸ½
astrology	ğŸ‡ªğŸ‡­
passport control	ğŸš£ğŸ½
flag for liechtenstein	ğŸš½
vertical traffic light	ğŸš½
school	ğŸš½
italy	ğŸš½
store	ğŸš½
tram	ğŸš½
bar chart	ğŸš½
taurus	ğŸš½
deeper brown white up pointing backhand index	ğŸš½
level slider	ğŸ‘
hurt	ğŸ‘
maltese flag	ğŸ‘
penguin	ğŸŒ‰
milk	ğŸŒ‰
doner kebab	ğŸŒ‰
flag for peru	ğŸŒ‰
perfect	ğŸŒ‰
sassy	ğŸŒ‰
cheese	ğŸŒ‰
chili pepper	ğŸŒ‰
beers	ğŸŒ‰
information	ğŸŒ‰
medal	ğŸˆ
mountain	ğŸˆ
woman frowning	ğŸˆ
white exclamation mark ornament	ğŸˆ
hot chocolate	ğŸˆ
clutch	ğŸ‡®ğŸ‡±
finals	ğŸ‡®ğŸ‡±
marina	ğŸ‡®ğŸ‡±
cold	â¬œ
japanese dolls	ğŸ‘‰ğŸ¾
mobile phone	âš“
circle arrows with number 1	âš“
profile	âš“
seafood	âš“
zodiac	âš“
capricorn	âš“
stove	âš“
bahrani flag	âš“
disneyland	âš“
regional indicator symbol letters gp	âš“
flag for bangladesh	âš“
flag for fiji	ğŸ‘§ğŸ½
cupid arrow	ğŸ‘ƒğŸ½
snowman	ğŸ˜
curry	ğŸ˜
estonian flag	ğŸ˜
eyeballs	ğŸ˜
white dancer	ğŸ˜
galloping horse	ğŸ˜
sun	ğŸ˜
black bicyclist	ğŸ˜
tongue	ğŸ˜
large red circle	ğŸ˜
light brown boy	ğŸ‡©ğŸ‡´
forbid	ğŸ‡©ğŸ‡´
black nib	ğŸ‡©ğŸ‡´
ho ho ho	ğŸ‡©ğŸ‡´
baked potato	âœ‹ğŸ¼
semi	ğŸ
flag for mauritania	ğŸ
christian cross	ğŸ
paper	ğŸ
weary	ğŸ
apple times	ğŸ
deeper brown person with blond hair	ğŸ
umbrella with rain drops	ğŸ
annoyed	ğŸ
registered sign	ğŸ
see	ğŸ‘“
black person frowning	ğŸ‘“
flag for bhutan	ğŸ‘“
house buildings	ğŸ‘“
myth	ğŸ‘“
croc	ğŸ‘“
potassium	ğŸ‘“
black white up pointing backhand index	ğŸ‘“
pool	ğŸ‘“
slow	ğŸ‘“
circle	ğŸ‘“
volcano	ğŸ‘“
black pedestrian	ğŸ‘“
keycap digit three	ğŸ‘“
hand	ğŸ‡¸ğŸ‡¸
gross	ğŸ‡¸ğŸ‡¸
shirt	ğŸ”¥
black square button	ğŸ”¥
pineapple	ğŸ”¥
hairdresser	ğŸ”¥
deeper brown dancer	â˜•
cash	â˜•
regional indicator symbol letters au	â˜•
light beam	â˜•
bactrian	1âƒ£ï¸
white swimmer	ğŸ™
black girl	ğŸ™
elderly woman	ğŸ¨
prawn	ğŸ¨
greek	ğŸ¨
constellation	ğŸ¨
womans boots	ğŸ¨
olive toned dancer	ğŸ¨
maiden	ğŸ¨
money	ğŸ¨
squared ok	ğŸ¨
mustache	ğŸ¨
green apple	ğŸ¨
poop	â›²
olive toned father christmas	â›²
hamster	â›²
unit	â›²
dancer	ğŸŒœ
bearer	ğŸŒœ
white bath	ğŸŒœ
suspension railway	ğŸŒœ
japan post	ğŸŒœ
luggage	ğŸŒœ
high	ğŸŒœ
bathroom	ğŸŒœ
bend	ğŸŒœ
bookmark	ğŸŒœ
designer	â¤µï¸
helpless face	ğŸ¤´
eight ball	ğŸ•“
smirking	â›ˆ
regional indicator symbol letters vi	â
womans hat	ğŸ‘¶ğŸ¿
hello	ğŸ
large blue diamond	ğŸ
yellow fruit	ğŸ
olive toned person bowing deeply	ğŸ
confidence	ğŸ
motor scooter	ğŸ
school	ğŸ
litter	ğŸ
face	ğŸ
entertainment	ğŸ
flag for anguilla	ğŸ
light brown bride with veil	ğŸ‘·ğŸ½
high voltage sign	ğŸ›
night	ğŸ›
white sun with small cloud	ğŸ›
magnifying glass	ğŸ›
transport	ğŸ›
red flag	ğŸ›
swimming	ğŸ›
japanese	ğŸ›
trident emblem	ğŸ›
light brown fisted hand sign	ğŸ›
runner	ğŸ›
leisure	ğŸ›
injured	ğŸ›
water	ğŸ›
yellow	ğŸˆ
ghanaian flag	ğŸˆ
praise hands	ğŸˆ
fry	ğŸˆ
telephone	ğŸˆ
ham	ğŸˆ
black medium small square	ğŸˆ
farming	ğŸˆ
streamers	ğŸˆ
light brown older man	ğŸ™ğŸ½
steaming bowl	ğŸ‡¨ğŸ‡¬
cutting hair	ğŸ˜¶
black bat	ğŸ˜¶
oncoming taxi	ğŸ˜¶
smiling	ğŸ˜¶
timepiece	ğŸ˜¶
tattoo	ğŸ˜¶
egyptian flag	ğŸ˜¶
white police officer	ğŸ‡µğŸ‡·
music notes	ğŸ‡µğŸ‡·
goat	ğŸŒ¼
hinamatsuri	ğŸŒ¼
keycap ten	ğŸŒ¼
church heart	ğŸŒ¼
pouting face	ğŸŒ¼
stars	ğŸ‡¨ğŸ‡³
notes	ğŸ‡¨ğŸ‡³
robot face	ğŸ‡¨ğŸ‡³
deck of cards	ğŸ’ªğŸ¿
xmas	ğŸ‡§ğŸ‡·
mixed	ğŸ‡§ğŸ‡·
film projector	ğŸš³
flag for sri lanka	ğŸš³
ladies hat	ğŸš³
flag for australia	ğŸš³
rainy	ğŸš³
flag for curaÃ§ao	ğŸ‘¡
policewoman	ğŸ‘¡
hospital	ğŸ‘ŠğŸ»
kissing face with closed eyes	ğŸ™ğŸ¼
scorpion	ğŸ“–
pepperoni pizza	ğŸ“–
spaghetti	ğŸ“–
survivor	ğŸ”
inbox tray	ğŸ”
sparkle heart	ğŸ™‡
bunch	ğŸ™‡
light brown white down pointing backhand index	ğŸ™‡
first	ğŸ™‡
suitcase	ğŸ™‡
olive toned haircut	ğŸ™‡
smirking face	ğŸ™‡
xmas tree	ğŸ™‡
stars	ğŸ™‡
cyclone	ğŸ™‡
world emoji day	âœŠğŸ»
flirting	ğŸ›‚
virus	ğŸ›‚
excitement	ğŸ›‚
sad cat	ğŸ›‚
airing of grievances	ğŸ›‚
black	ğŸ›‚
regional indicator symbol letters bz	ğŸ›‚
pet	ğŸ›‚
mountain	ğŸ¾
ambulance	ğŸ¾
family of two women with one boy	ğŸ¾
puckered	ğŸ¾
lollypop	ğŸº
heart	ğŸº
black ant	ğŸº
palette	ğŸº
regional indicator symbol letters do	ğŸ‡²ğŸ‡²
flag for aruba	ğŸ‡²ğŸ‡²
soothing	ğŸ‡¿ğŸ‡²
poo	ğŸ‡¿ğŸ‡²
marriage	ğŸ’¶
railway wagon	ğŸ’¶
death	ğŸ’¶
drum with drumsticks	ğŸ’¶
casket	ğŸ’¶
ball	ğŸ’¶
baby	ğŸ’¶
daze	ğŸ’¶
map of japan	ğŸ’¶
special	ğŸˆ
nobel	ğŸˆ
dejected	ğŸˆ
regular train	ğŸˆ
regional indicator symbol letters al	ğŸˆ
smiley face	ğŸˆ
escargot	ğŸ‡´
musical score	ğŸ‡²ğŸ‡¿
pastels	ğŸ‡²ğŸ‡¿
confused	ğŸŒ©
sand	ğŸ˜§
sedan	ğŸ˜§
scales of justice	ğŸ˜§
eject symbol	ğŸ˜§
closed umbrella	ğŸ˜§
children	ğŸ˜§
yield	ğŸ˜§
oink	ğŸ˜§
imperial dolls	ğŸ†
attention	ğŸ†
cobweb	ğŸ¥
white older man	ğŸ•¯
white frowning face	ğŸ‘¨â€ğŸ‘©â€ğŸ‘§
dash	ğŸ‡±ğŸ‡¾
dawn	ğŸ‡±ğŸ‡¾
rounded tree	ğŸ‘š
watermelon	ğŸ‘š
surprise	ğŸ‘š
pure	ğŸ‘š
unicorn face	ğŸ‘š
regional indicator symbol letters ye	ğŸ‘š
red book	ğŸ‘š
controller	ğŸ‘š
gelding	ğŸ‘š
piece of cake	ğŸ‘š
tropical drink	ğŸ‘š
regional indicator symbol letters sm	ğŸ‘š
bar	ğŸ‘š
japanese akita	ğŸ‘š
circle	ğŸ’©
japanese goblin	ğŸ’©
confuse	ğŸ’©
flag for bulgaria	ğŸ’©
cloths	ğŸ’©
iphone	ğŸ’©
down triangle	ğŸ’©
blushing face	ğŸ”¶
user	ğŸ¤—
music	ğŸ¤—
poultry	ğŸ¤—
audio	ğŸ¤—
night	ğŸ¤‘
loop symbol	ğŸ¤‘
father	ğŸ¤‘
stick	ğŸ”°
regional indicator symbol letters ao	ğŸ”°
olive toned white right pointing backhand index	ğŸ”°
blow a kiss	ğŸ™ğŸ½
wine	ğŸ‡ğŸ»
water	ğŸ˜¸
white thumbs up sign	ğŸ˜¸
sake	ğŸ˜¸
bear	ğŸ˜¸
studio microphone	ğŸ˜¸
love	ğŸ˜¸
steaming	ğŸ˜¸
jar	âœ
scape	ğŸš¿
wrist watch	ğŸš¿
train	ğŸš¿
planets	ğŸš¿
smiling	ğŸš¿
collapsed umbrella	ğŸš¿
board	ğŸš¿
horse head	ğŸš¿
crap	ğŸš¿
space	âš½
flag for senegal	âš½
sun	âš½
â„¹ info	âš½
flag for china	ğŸ“…
facsimile	ğŸ“…
lips	ğŸ“…
homosexual	ğŸ¦‚
oni	â
runner	â
chinese flag	â
throne	ğŸ’†
cow	ğŸ’†
regional indicator symbol letters li	ğŸ’†
tide	ğŸ’‚ğŸ¼
revolving	ğŸ“¥
cherry	â—¼ï¸
articulated	ğŸ˜
flag for russia	ğŸ˜
bengal tiger	ğŸ˜
planning	ğŸ˜
smooch	ğŸ˜
light brown clapping hands sign	ğŸ˜
metropolitan	ğŸ˜
sadface	ğŸ˜
delivery truck	7ï¸âƒ£
keycap digit two	ğŸ¬
yawning	ğŸ¬
american dollar	ğŸ¬
black person raising both hands in celebration	ğŸ¬
cry	ğŸ¬
loaf of bread	ğŸ¬
man with turban	ğŸ¬
regional indicator symbol letters gr	ğŸ¬
mantelpiece clock	âœ”ï¸
dominican flag	ğŸ·
deeper brown information desk person	ğŸ·
sound	ğŸ‡¿
black father christmas	ğŸ©
triangular	ğŸ©
foggy city	ğŸ©
visa card	ğŸ©
transportation	ğŸ©
couple kissing	ğŸ©
sorrow	ğŸ©
greek	ğŸ©
popping corn	ğŸ©
core	ğŸ‡¬
olive toned person with folded hands	ğŸŒ¾
mountain railway	ğŸŒ¾
canadian	ğŸŒ¾
couch and lamp	ğŸŒ¾
mounted	ğŸŒ¾
lemon	ğŸŒ¾
academic	ğŸŒ¾
flag for andorra	ğŸŒ¾
mother	ğŸŒ¾
flag for albania	ğŸ™ƒ
cloud	ğŸ™ƒ
zodiac	ğŸ’»
locomotive	ğŸ’»
flags	ğŸ’»
plumbing	ğŸ’»
water	ğŸ’»
game	ğŸš¼
sad	ğŸš¼
sun behind cloud	ğŸš¼
flag for honduras	ğŸš¼
dog	ğŸš¼
information desk person	ğŸš¼
pedal	ğŸš¼
deeper brown face with no good gesture	ğŸš¼
psychic	ğŸš¼
smiling	ğŸš¼
painting	ğŸš¼
small bag	ğŸ‡ªğŸ‡¹
smiling face with halo	ğŸ‡ªğŸ‡¹
acoustic	â™¿ï¸
disney	ğŸ•°
middle east	ğŸ¥‘
paperclip	â–¶ï¸
british	â–¶ï¸
fÅ«rin	â›°
kadomatsu	â­•ï¸
show	ğŸ‡µğŸ‡±
globe	ğŸ‡µğŸ‡±
radical 74	ğŸ¥
qing	ğŸ¥
flower	ğŸ¥
bottle with popping cork	ğŸ¥
magnifying glass	ğŸš£
bessie	ğŸš£
smile	ğŸš£
olive toned older man	ğŸš£
snake flag of martinique	ğŸš£
keep it 100	ğŸš£
regional indicator symbol letters ky	ğŸš£
silly	ğŸ‰
school satchel	ğŸ‰
glow	ğŸ‰
regional indicator symbol letters sa	ğŸ‰
airplane	ğŸ‰
new	ğŸ‰
white sun behind cloud	ğŸ‰
payday	ğŸ‰
light brown ok hand sign	ğŸ‰
party	â›²ï¸
smile	ğŸ‡¸ğŸ‡©
white	ğŸ‡¸ğŸ‡©
fall leaves	â¹
elderly man	ğŸ€
skiing	ğŸ€
blond man	ğŸ€
engine	ğŸ€
mono	ğŸ€
regional indicator symbol letters es	ğŸ€
australian flag	ğŸ™‰
black white left pointing backhand index	ğŸ™‰
sorrowful	ğŸ™‰
service	ğŸ™‰
drink	ğŸ™‰
grimacing face	ğŸ‘³ğŸ¼
presents	ğŸ‡ºğŸ‡¾
toilet	ğŸ‡ºğŸ‡¾
police cars revolving light	ğŸ‡¨ğŸ‡­
grinning face	ğŸ‡¨ğŸ‡­
bag	ğŸ‡¨ğŸ‡­
ornaments	ğŸ‡¨ğŸ‡­
ride	â˜¹
regional indicator symbol letters tn	ğŸšœ
printed page	ğŸšœ
regional indicator symbol letters ng	ğŸšœ
flag for sierra leone	ğŸšœ
rockmelon	ğŸšœ
tomato	ğŸšœ
flag for canada	ğŸ‡¯ğŸ‡²
bowl of ice cream	ğŸ‡¯ğŸ‡²
mystify	ğŸ’›
heart	ğŸ’›
flag for spain	ğŸ’›
observing	ğŸ’›
swimmer	ğŸ’›
flag for nigeria	ğŸ’›
regional indicator symbol letter o	ğŸ’›
japanese	ğŸ’›
building construction	ğŸ’›
space	ğŸ’›
north west arrow	ğŸ’›
engagement	ğŸ’›
starburst	ğŸ’›
zodiac	ğŸ’›
greek	ğŸ’›
regional indicator symbol letters ug	ğŸŒ¯
waffle	ğŸŒ¯
savory	â¬†ï¸
baby angel	âš™
elementary school	ğŸ’‚ğŸ»
tram car	â•
boarding	ğŸ‘—
baby	ğŸ‘—
citrus	ğŸ‘—
dizzy	ğŸ
jaguar	ğŸ
cute	ğŸ
melancholy	ğŸ
water	ğŸ
deeper brown construction worker	ğŸ
thumb	ğŸ
first	ğŸ
circled ideograph accept	ğŸ
flag for bouvet island	ğŸ
billy	ğŸ
think	ğŸ
hot	ğŸ”“
panda face	ğŸ”“
explode	ğŸ”“
food	â™ï¸
apple watch	â™ï¸
mastercard	â™ï¸
regional indicator symbol letters fo	â™ï¸
donut	â™ï¸
hamburger	â™ï¸
net	â™ï¸
zodiac	â™ï¸
space	â™ï¸
scorpion	ğŸ‡¬ğŸ‡²
clock	ğŸ‡¬ğŸ‡²
purple goblin	ğŸ‰
lowercase	ğŸ‰
bloated	ğŸ‰
greek	ğŸ‰
arrow	ğŸ‰
emergency room	ğŸ›©
cinema	ğŸŒˆ
dairy	ğŸŒˆ
bottle	ğŸŒˆ
light brown runner	ğŸŒˆ
morn	ğŸŒˆ
spy	ğŸŒˆ
happy cat	ğŸŒˆ
school bag	ğŸŒˆ
part alternation mark	ğŸŒˆ
carve	ğŸŒˆ
chocolate	ğŸ‘‚ğŸ¿
phase	ğŸš
flag for mayotte	ğŸš
groom	ğŸš
mount fuji	ğŸš
butt	ğŸš
flag for india	ğŸš
clock face six oclock	ğŸš
right anger bubble	ğŸ‘´ğŸ½
olive toned ear	ğŸŒ
medium black circle	ğŸŒ
train	ğŸŒ
core	ğŸŒ
medical	ğŸŒ
angry	ğŸŒ
livestock	ğŸŒ
musical	ğŸ“¯
radio	ğŸ“¯
chicken	ğŸ“¯
wind	ğŸ™†ğŸ¼
gallop	ğŸ„
fear	ğŸ„
australia	ğŸ„
ice cream	ğŸ„
zodiac	ğŸ„
chicken	ğŸ„
nursery	ğŸ„
helo	ğŸ„
starry night	ğŸ„
black nose	ğŸ„
celebration	ğŸ„
shampoo	ğŸ„
fruit	ğŸ„
builder	ğŸ‡²ğŸ‡±
naughty	ğŸ‡²ğŸ‡±
bat	ğŸ“›
kikazaru	ğŸ“›
mansion	ğŸ“›
digital radio	ğŸ“›
punch	ğŸ…ğŸ¾
decorate	ğŸ‡°ğŸ‡­
avatar	ğŸ‡°ğŸ‡­
piano	ğŸ‡¬ğŸ‡«
camel	ğŸ‡¬ğŸ‡«
yen	ğŸ‡¬ğŸ‡«
red	â›ªï¸
japanese	ğŸ‡¨ğŸ‡¨
gallery	ğŸŒ¨
high school	ğŸ‘»
serve	ğŸ‘»
regional indicator symbol letters bf	ğŸ‘»
cd rom	â™¦ï¸
regional indicator symbol letters gf	â™¦ï¸
å¾—	2âƒ£ï¸
sign	ğŸ 
flag for paraguay	ğŸ 
hot beverage	ğŸ 
sunset over buildings	ğŸ 
dragon	ğŸ 
bermudan flag	ğŸ 
regional indicator symbol letters pw	ğŸ 
fishing rod	ğŸ 
tony	ğŸ‡«ğŸ‡®
white nose	ğŸ‡«ğŸ‡®
snowboarding	ğŸ¤
front of bus	ğŸ¤
roast turkey	ğŸ¤
regional indicator symbol letters ee	ğŸ¤
shirt	ğŸ¤
cheeks	ğŸ¤
steaming	ğŸ¤
lick	ğŸ’ª
tomato	ğŸ’ª
spit	ğŸ’ª
flag for malawi	ğŸ’ª
sheep	ğŸ’ª
money	ğŸ’ª
cooked	âš“ï¸
virgo	âš“ï¸
â„¹ tourist information	âš“ï¸
dancing girls	âš“ï¸
negative squared cross mark	âš“ï¸
reproduction	âš“ï¸
up	âš“ï¸
black older woman	âš“ï¸
basketball	âš“ï¸
boutique 109	ğŸ…
pc	ğŸ¤·
sneezing face	ğŸ¤·
alphabet	ğŸ•–
olive toned bride with veil	ğŸŒ
tortoise	ğŸŒ
medallion	ğŸŒ
light brown face with no good gesture	ğŸŒ
side of police car	ğŸŒ
deeper brown horse racing	ğŸŒ
wheat	ğŸŒ
diamonds	ğŸŒ
deposit	ğŸ™‹ğŸ¿
sophisticated	âš½ï¸
push bike	âš½ï¸
fries	âš½ï¸
frog	ğŸ‘©â€ğŸ‘©â€ğŸ‘§â€ğŸ‘§
flag for maldives	ğŸ‡°ğŸ‡·
pig	ğŸ‡°ğŸ‡·
fried egg	ğŸ“Š
zodiac	ğŸ›¢
help	ğŸŒ
end with leftwards arrow above	ğŸŒ
domestic water buffalo	ğŸŒ
car hood	ğŸŒ
heart hospital	ğŸŒ
soft	ğŸŒ
jolly	ğŸ­
smoke	ğŸ­
melancholy	ğŸ­
face with open mouth and cold sweat	ğŸ­
lady beetle	ğŸ­
boat	ğŸ­
monkey	ğŸ­
office building	ğŸ­
costume	ğŸ‡µğŸ‡«
grapes	ğŸ¤¢
feet	ğŸ¤¢
yummy	ğŸ¤¢
legendary	ğŸ¤¢
wry	ğŸ›°
gift box	ğŸŒ
globe	ğŸŒ
frown	ğŸŒ
regret	ğŸŒ
turrets	ğŸŒ
bee	ğŸŒ
ferry	ğŸŒ
shibuya 109	ğŸŒ
flag for belize	â›½
sake bottle and cup	â›½
flag for slovenia	â›½
kids crossing	â›½
bank	ğŸš´ğŸ½
transport	ğŸ–
ocean wave	ğŸ–
bunny	ğŸ–
flag for botswana	ğŸ’¥
dark moon	ğŸ’¥
waste	ğŸ’¥
carp	ğŸ’¥
personal computer	ğŸ’¥
kissy	ğŸ’¥
pointing up	ğŸ’¥
food	ğŸ’¥
astrology	ğŸ’¥
monkey head	ğŸ’¥
hourglass with flowing sand	ğŸ’¥
cheeseburger	ğŸ™ğŸ»
ride	ğŸšƒ
monkey	ğŸšƒ
flag for france	ğŸšƒ
metropolitan	ğŸšƒ
alembic	ğŸšƒ
man in business suit levitating	ğŸšƒ
fortune teller	ğŸšƒ
dancing	ğŸšƒ
blush	ğŸšƒ
decoration	ğŸšƒ
confounded face	ğŸ©
clock face eleven oclock	ğŸ©
hotdog	ğŸ©
black woman	ğŸ©
vine	ğŸ©
deeper brown white left pointing backhand index	ğŸ©
open mailbox with raised flag	ğŸ©
person raising both hands in celebration	ğŸ©
wind	ğŸ©
negative squared latin capital letter o	ğŸ©
bike	ğŸ©
beer mug	ğŸ©
when you wish upon a star	ğŸ©
july	ğŸ©
snap	ğŸ©
vocal	ğŸ©
regional indicator symbol letter p	ğŸ©
family with boy and girl	ğŸ›€ğŸ½
ladybird	ğŸ‡¦ğŸ‡©
music	ğŸ‡¦ğŸ‡©
light brown information desk person	ğŸ‡¦ğŸ‡©
dash symbol	âšªï¸
light rail	ğŸ’ğŸ¾
cupid	ğŸ”…
regional indicator symbol letters sd	ğŸ”…
hammer and wrench	ğŸ”…
flag for lebanon	ğŸ‘ˆğŸ¼
value	ğŸ‡ğŸ¿
triple heart	ğŸ‡²ğŸ‡¸
girl	ğŸ‡²ğŸ‡¸
phase	ğŸ‘…
baggage	ğŸ‘…
tractor	ğŸ‘…
card index dividers	ğŸ‘…
regional indicator symbol letters dk	ğŸ‘…
unimpressed	ğŸ‘…
sikh	ğŸ‘…
asia	ğŸ‘…
sleigh	ğŸ‘…
phase	ğŸ‘…
black square for stop	ğŸ‘…
eat	ğŸ‘…
phone with arrow	ğŸ‘…
boat with paddles	ğŸ‘…
motorcycle	ğŸ‘…
stinky	ğŸ‘…
planet	ğŸ¤
pride	ğŸ¤
smiling face with horns	ğŸ¤
constellation	ğŸ¤
yum	ğŸ¤
flag for british virgin islands	ğŸ¤
rice	ğŸ¤
light brown girl	ğŸ˜¼
jewish	ğŸ˜¼
jealous	ğŸ˜¼
gust of wind	ğŸ˜¼
headdress	ğŸ˜¼
phase	ğŸ˜¼
star trek	ğŸ˜¼
crab	4âƒ£ï¸
universe	ğŸš°
clean	ğŸš°
light brown waving hand sign	ğŸš°
music note	ğŸš°
speaking head in silhouette	ğŸš°
congratulations	ğŸš°
regional indicator symbol letters ch	ğŸš°
graduation cap	ğŸš°
jogging	ğŸš°
regional indicator symbol letters my	ğŸ
water	ğŸ
flan	ğŸ
circus tent	ğŸ
newborn	ğŸ
drool	ğŸ
bills	ğŸ
bowling	ğŸ‘ŒğŸ¼
points	ğŸ­
elsa	ğŸ­
tar	ğŸ­
circle and star	ğŸ­
crying face	ğŸ­
wallet	ğŸ­
regional indicator symbol letters pg	ğŸ­
yes	ğŸ­
white white left pointing backhand index	ğŸ­
black and yellow striped sign	ğŸŒ²
flag for bermuda	ğŸŒ²
knee high boots	ğŸŒ²
electric	ğŸŒ²
shoshinsha mark	ğŸŒ²
flying	ğŸŒ²
olive toned face with ok gesture	ğŸ‘²ğŸ»
boy	ğŸ‡¸ğŸ‡¦
deeper brown ear	ğŸ‡¸ğŸ‡¦
card	ğŸ‡¦ğŸ‡¸
boat	ğŸ‡¦ğŸ‡¸
burrito	ğŸ‡¦ğŸ‡¸
olive toned guardsman	ğŸ‘ğŸ¼
chicken	ğŸ‘¶ğŸ½
regional indicator symbol letters ck	ğŸ•
regional indicator symbol letter s	ğŸ•
restroom	ğŸ•
package	ğŸ•
empress	ğŸŒ¡
board	ğŸŒ¡
passion	ğŸŒ¡
station	ğŸ“©
duty	ğŸ“©
imprints	ğŸ“©
irish flag	ğŸ
light	ğŸ
laughing	ğŸ
100	ğŸ
black scissors	ğŸ
christmas present	ğŸ
regional indicator symbol letters rs	ğŸ
cute	ğŸ
regional indicator symbol letters ke	ğŸ
slightly happy	ğŸ
sex	ğŸ
face with no good gesture	ğŸ
couple love	ğŸ
pig	ğŸ
light brown swimmer	ğŸ
plus	ğŸ
fireworks	ğŸ
regional indicator symbol letters mv	ğŸ––ğŸ¼
expressionless	ğŸ‡°ğŸ‡³
bride	ğŸ™
wednesday	ğŸ™
ocean	ğŸ™
performing arts	ğŸ™
investigator	ğŸ™
dress	ğŸ™
raised hand with part between middle and ring fingers	ğŸ™
drink	ğŸ‡¬ğŸ‡¶
waxing	ğŸ‡¬ğŸ‡¶
regional indicator symbol letters lk	ğŸ‡¹ğŸ‡¯
zzz face	ğŸ‡¹ğŸ‡¯
regional indicator symbol letters sc	ğŸ’—
ceremonial	ğŸ’—
fruit punch	ğŸ’—
japanese	â“
comet	ğŸ’¯
wink	ğŸ’¯
birthday	ğŸ’¯
flight	ğŸ’¯
admiralty pattern anchor	ğŸ’¯
white left pointing backhand index	ğŸ’¯
stuffed flatbread	ğŸ’¯
wrap	ğŸ’¯
kissy face	ğŸ’¯
shell	ğŸ’¯
system card	ğŸ’¯
apple	ğŸ’¯
sad	ğŸ’¯
snooker	ğŸ’¯
dress	ğŸ”›
phone	ğŸ”›
face	ğŸ…±ï¸
f1	ğŸ˜€
soccer	ğŸ˜€
last quarter moon with face	ğŸ˜€
artist	ğŸ˜€
stride	ğŸ˜€
dromedary	ğŸ˜€
laptop	ğŸ˜€
crown	ğŸ˜€
rice	ğŸ¥
panda	ğŸ¥
eggplant	ğŸ¥
person with folded hands	ğŸ¥
olive toned flexed biceps	ğŸ¥
powerful	ğŸ¥
solar eclipse	ğŸ¥
night	ğŸ¥
royal	ğŸ¥
royalty	ğŸ¥
kitten paw prints	ğŸ¥
scared	ğŸ‘¨ğŸ¼
mountain	ğŸ•
squared free	ğŸ“ª
cub	ğŸ™‡ğŸ½
camera	ğŸ 
space shuttle	ğŸ 
hospital	ğŸ 
regional indicator symbol letters uz	ğŸ 
fungi	ğŸ 
cocktail glass	ğŸ 
happy	ğŸ 
void	ğŸ 
regional indicator symbol letters kg	ğŸ 
flower	ğŸ 
olive toned police officer	ğŸ 
devil horns	ğŸ»
motor boat	ğŸ»
fire department	ğŸ»
pucker	ğŸŒ
lady bug	ğŸŒ
woman	ğŸŒ
mouse	ğŸ™ŒğŸ½
locomotive	ğŸš˜
two men holding hands	ğŸš˜
detective	ğŸš˜
creme caramel	ğŸš˜
winning	ğŸš˜
sprint	ğŸš˜
mens toilet	ğŸš˜
white up pointing backhand index	ğŸ˜©
regional indicator symbol letters km	ğŸ˜©
frame with picture	ğŸ˜©
sweat	ğŸ˜©
lithuanian flag	ğŸ˜©
member	ğŸ˜©
two flags	ğŸ˜©
flag for samoa	ğŸ˜©
clockwise downwards and upwards open circle arrows	ğŸ˜©
keycap digit nine	ğŸšµ
smirk	ğŸšµ
leaf	ğŸšµ
sealed lips	ğŸšµ
cream	ğŸšµ
cinema screen	ğŸšµ
halloween	ğŸšµ
horse	ğŸšµ
teacup without handle	ğŸšµ
planet	ğŸ‡°ğŸ‡¾
little penguin	ğŸ‡°ğŸ‡¾
feet	ğŸ‡°ğŸ‡¾
happy sweat	ğŸ–¨
play button	ğŸ¦‰
campsite	ğŸ‘›
clingy	ğŸ‘›
olive toned construction worker	ğŸ‘›
exasperated	ğŸ‘›
new	ğŸ‘›
cue ball	ğŸ‘›
merchandise	ğŸ‘›
boys holding hands	ğŸ‘›
sound	ğŸ‘›
smile	ğŸ‘›
arab	ğŸ‘®ğŸ½
usa flag	ğŸ”
hog	ğŸ”
jet	ğŸ”
train	ğŸ…
ferment	ğŸ…
kidding	ğŸ…
sky	ğŸ…
buds	ã€°ï¸
tired face	ğŸ€
bank branch	ğŸ€
sign	ğŸ€
space	ğŸ€
lather	ğŸ€
independence	ğŸ€
dollar bill	ğŸ€
wish	ğŸ€
white pedestrian	ğŸ€
double curly loop	âš¡ï¸
yellow star	â˜‚
paper	ğŸ‘ğŸ¾
scales	ğŸš‰
rice	ğŸš‰
crazy	ğŸš‰
regional indicator symbol letters zw	ğŸš‰
keycap digit five	ğŸš‰
family of two women with two boys	â™Œ
luck	â™Œ
russian flag	â™Œ
world map	â™Œ
flag for brunei	â™Œ
romance	â™Œ
family of two men with one boy	â™Œ
freshwater fish	â™Œ
airplane arriving	ğŸ‡©ğŸ‡ª
flush	ğŸ‡©ğŸ‡ª
balls	ğŸ‡©ğŸ‡ª
monkey	ğŸ‡©ğŸ‡ª
constellation	ğŸ‡¬ğŸ‡§
moon	ğŸ‡¬ğŸ‡§
regional indicator symbol letters lv	ğŸ‡¬ğŸ‡§
cheers	ğŸ‡¬ğŸ‡§
cactus	ğŸ‡¬ğŸ‡§
post office	ğŸ‡¬ğŸ‡§
taxi	ğŸ‘ğŸ¾
grinning	ğŸ“
student	â™Šï¸
candy	â™Šï¸
ocean	â™Šï¸
rv	â™Šï¸
primate	â™Šï¸
love	â™Šï¸
movies	â™Šï¸
sign	â™Šï¸
deeper brown person raising both hands in celebration	âš¡
purple	âš¡
milky	âš¡
martini	ğŸŒ”
silhouette	ğŸŒ”
werewolves	ğŸŒ”
flag for vietnam	ğŸŒ”
eagle	ğŸŒ”
dingo	ğŸŒ”
olive toned bicyclist	ğŸŒ”
duck face	ğŸŒ”
moo	ğŸ›µ
regional indicator symbol letters tg	ğŸ›µ
plantain	ğŸ›µ
flag for nauru	ğŸ›µ
cry	ğŸ‡»ğŸ‡®
moai	ğŸ‡»ğŸ‡®
sweet	ğŸ›
lovestruck	ğŸ›
family of a man and woman with one girl and one boy	ğŸ‘‡ğŸ»
greek	â†—ï¸
painting	ğŸ˜ 
regional indicator symbol letters aw	ğŸ˜ 
happy	ğŸ˜ 
libra	ğŸ˜ 
japan	ğŸ˜ 
moon	ğŸ˜ 
ice hockey	ğŸ˜ 
jockey	ğŸŸ
eu flag	ğŸŸ
flag for kazakhstan	ğŸ”‰
romance	ğŸ”‰
electric guitar	ğŸŒ´
æº€	ğŸŒ´
restriction	ğŸŒ´
singing	ğŸŒ´
school	ğŸŒ´
dessert	ğŸŒ´
evening	ğŸŒ´
phase	ğŸŒ´
cake	ğŸŒ´
confound	ğŸŒ´
zip it	ğŸ‡®ğŸ‡¸
mask	ğŸ‡®ğŸ‡¸
waste	ğŸ¥‚
spooky	ğŸ¥‚
thought	ğŸ¥‚
clip	ğŸ¥‚
regional indicator symbol letters gh	âœŒï¸
stars	âœŒï¸
flag for saudi arabia	âœŒï¸
sport	âœŒï¸
grid girl	âœŒï¸
regional indicator symbol letters us	â˜ï¸
keyboard	â˜ï¸
noodles	â˜ï¸
japanese castle	ğŸ 
music	ğŸ 
love	ğŸ 
shark	ğŸ 
black thumbs up sign	ğŸ 
relief	ğŸ 
regional indicator symbol letters cg	ğŸ 
blue beam	ğŸ 
happy person raising one hand	ğŸ 
explosion	â™‰ï¸
daughter	â™‰ï¸
light brown pedestrian	â™‰ï¸
full	â™‰ï¸
revolving hearts	â™‰ï¸
sleep	â™‰ï¸
bulb	â™‰ï¸
shadow moon	â™‰ï¸
cyclist	â›¹
sign	ğŸ”­
vhs	ğŸ”­
card with heart	ğŸ˜¿
marshallese flag	ğŸ˜¿
observation wheel	ğŸ˜¿
bills	ğŸ˜¿
red spark	ğŸ˜¿
smug face	ğŸ˜¿
bk	ğŸ˜¿
formal wear	ğŸ˜¿
regional indicator symbol letters gu	ğŸ˜¿
spiritual	ğŸ˜¿
quarter	ğŸ˜¿
nail polish	ğŸ˜¿
phone battery	8ï¸âƒ£
celebrate	ğŸšµğŸ»
no good	â™’ï¸
pink	â™’ï¸
weep	â™’ï¸
roller coaster	â™’ï¸
chick	â™’ï¸
fruit machine	â™’ï¸
banana	â™’ï¸
pin	â™’ï¸
uv	â™’ï¸
night with stars	ğŸ‘·
holiday inn	ğŸ‘·
canada	ğŸ‘·
surprised face	ğŸ‘·
sleuth or spy	ğŸŒ›
flag for french polynesia	ğŸŒ›
lady	ğŸŒ›
lunchbox	ğŸŒ›
kernel	ğŸŒ›
sax	ğŸŒ›
embarrassed	ğŸŒ›
flag for vanuatu	ğŸŒ›
regional indicator symbol letters tf	ğŸŒ›
flag for eritrea	ğŸŒ›
empire apple	ğŸ’†ğŸ»
lemonade	ğŸ‘‹ğŸ»
garbage	ğŸ‘ğŸ»
stop	ğŸ¥
correct	ğŸ¥
flag for togo	ğŸ¥
olive toned fisted hand sign	ğŸ¥
regional indicator symbol letters ad	ğŸ¥
earth globe americas	ğŸ¥
slightly sad	ğŸ¥
mens symbol	ğŸ¥
electric bus	âš°
pint	âš°
cash	âš°
cute lion	ğŸ‘
goods	ğŸ‘
receptacle	ğŸ‘
american flag	ğŸ“»
sad sweat face	ğŸ“»
prostitution	ğŸ“»
man dancing	â­
plewds	â­
heavy dollar sign	â­
music	ğŸŠğŸ½
greek	ğŸš´
greek	ğŸš´
knife	ğŸš´
regional indicator symbol letters md	ğŸš´
red car	ğŸš´
shaved	ğŸš´
grandma	ğŸš´
perfect score	ğŸš´
dvd	ğŸ†˜
letter	ğŸ†˜
moon	ğŸ†˜
banknote with yen sign	ğŸ†˜
union	ğŸ•¹
food	ğŸ’ªğŸ¼
shawarma	ğŸ‡¨ğŸ‡²
chick hatching	ğŸ‡¨ğŸ‡²
light brown nose	ğŸ¸
private eye	ğŸ¸
money with wings	ğŸ¸
white older woman	ğŸ¸
details	ğŸ¸
ill	ğŸ¸
hump day	ğŸ¸
clinking glasses	ğŸ¸
construction worker	ğŸ¸
groom	ğŸ‡§ğŸ‡¶
uppercase	ğŸ¤
group	ğŸ¤
flag for cayman islands	ğŸ±
large	ğŸ±
rock on	ğŸ±
white up pointing index	ğŸ±
antenna with bars	ğŸ±
horse race	ğŸ±
imperial	ğŸ±
happy tears cat	ğŸ±
wild turkey	ğŸ±
okay	ğŸ”š
boring	ğŸ”š
tennis racquet	ğŸ‘ª
mexican flag	ğŸ‘ª
conversation	ğŸ‘ª
zodiac	ğŸ‘ª
plant	ğŸ‘ª
bullseye	ğŸ‘ª
flag for afghanistan	ğŸ‘ª
game	ğŸ‘ª
white face with no good gesture	ğŸ‘ª
blood donation	ğŸ‘ª
gesture	ğŸ‘ª
red wine	ğŸ’†ğŸ¾
cable	ğŸ˜°
night	ğŸ˜°
cook	ğŸ˜°
beach	ğŸ˜°
greek	ğŸ˜°
hyperopia	ğŸ˜°
apple	ğŸ˜°
flag for myanmar	ğŸ’€
rocket ship	ğŸ’€
sign	ğŸ’€
ticket	ğŸ’€
angel	ğŸ‡¦ğŸ‡¬
star	ğŸ‡
boiled rice	ğŸ‡
holiday	ğŸ‡
blue face	ğŸ‡
fog bridge	ğŸ‡
bacon	ğŸ‡
orange sky city	ğŸ‘µğŸ»
regional indicator symbol letters is	â™“ï¸
food	â™“ï¸
railway car	â™“ï¸
icon	â™“ï¸
dom rep flag	â™“ï¸
sun	â™“ï¸
bomb	â™“ï¸
instrument	â™“ï¸
white	ğŸ‘©â€â¤ï¸â€ğŸ’‹â€ğŸ‘©
numbers	ğŸ‘±ğŸ¼
help	ğŸ‘
kissing cat face with closed eyes	ğŸ‘
gasping face	ğŸ‘
royalty	ğŸ‘
input symbol for latin capital letters	ğŸ‘
water buffalo	ğŸ‘
unisex	ğŸ‘
transportation	ğŸ‘
muslim	ğŸ‘
arrow pointing rightwards then curving upwards	ğŸ‘
musical keyboard	ğŸ‘
surf	ğŸ‘
face	ğŸ‘
dizzy	ğŸ“ 
disapprove	ğŸ“ 
turban	ğŸ“ 
golf flag	3âƒ£ï¸
splashing water	âœ‹ğŸ½
garden snail	ğŸ¯
memorandum	ğŸ¯
fried	2ï¸âƒ£
home	ğŸš©
aubergine	ğŸš©
kiss	ğŸš©
clown face	ğŸš©
scooter	ğŸš©
minivan	ğŸš©
flag for malta	ğŸš©
triangle rice	ğŸš©
monkey	ğŸš©
triangle	ğŸ‘ƒğŸ¼
livestock	ğŸ’³
flag for montserrat	ğŸ’³
stop	ğŸ’³
championship trophy	ğŸ’³
ice	ğŸ’³
residence	ğŸ’³
public	ğŸ’³
flag for zambia	ğŸ’³
float	ğŸ’³
gold heart	ğŸ’³
public	ğŸ’³
diamond ring	ğŸ’³
grape	ğŸ’³
tattoo	ğŸ’³
no smoking symbol	ğŸ‡³ğŸ‡ª
ecstatic	ğŸ‡³ğŸ‡ª
centaur	âš–
astrology	âš–
flag for armenia	ğŸ”—
music	ğŸ”—
siren	ğŸ”—
ship	ğŸ”—
theater	ğŸ““
fighter	ğŸ““
frightened	ğŸ‡¸ğŸ‡¿
music	ğŸ‡¸ğŸ‡¿
tiger face	ğŸ›
christmas	ğŸ‡¬ğŸ‡º
footsteps	ğŸ‡¬ğŸ‡º
spouting whale	ğŸ‡¬ğŸ‡º
fish cake with swirl design	ğŸ‡¬ğŸ‡º
free	ğŸ‘²ğŸ¿
white man	ğŸ˜­
puzzle	ğŸ˜­
rocket	ğŸ˜­
white nail polish	ğŸ˜­
top	ğŸ˜­
monkey	ğŸ˜­
water	ğŸ˜­
phone call	ğŸ˜­
carousel	ğŸ˜­
magic	ğŸ˜­
own	ğŸ˜­
slot	ğŸ˜­
ball	ğŸ˜­
stalk	ğŸ‘¶ğŸ¼
trouble	ğŸ„
school	ğŸ„
regional indicator symbol letters nl	ğŸ„
blank	ğŸ„
back	ğŸ„
yearling	ğŸ„
cow face	ğŸ”¨
funeral urn	ğŸ”¨
dusk city	ğŸ”¨
chicken drumstick	ğŸ”¨
bikini	ğŸ’ƒğŸ½
university	ğŸ‘¼ğŸ¿
roasted sweet potato	ğŸ“¦
japanese	ğŸ‡­ğŸ‡³
regional indicator symbol letters cl	ğŸ‡­ğŸ‡³
drunk	â°
raining	â°
oncoming police car	â°
music	ğŸˆ²
imp	ğŸˆ²
no people	ğŸ˜“
fortune	ğŸ˜“
airlines	ğŸ˜“
cleavage	ğŸ˜“
confident	ğŸ˜“
seaweed	ğŸ˜“
sing	ğŸ˜“
regional indicator symbol letters kw	ğŸ˜“
stars	ğŸ˜“
showgirl	ğŸ˜“
drunk face	ğŸ‘â€ğŸ—¨
cowboy	ğŸ‘â€ğŸ—¨
truffle	âœŠğŸ¼
communication	â›”ï¸
scared	ğŸŒ
sign	ğŸŒ
boot	ğŸŒ—
coconut	ğŸŒ—
regional indicator symbol letters sx	ğŸŒ—
ring	ğŸŒ—
koala	ğŸŒ—
well done stamp	ğŸŒ—
young	ğŸŒ—
yes	ğŸŒ—
flag for french guiana	ğŸ“€
astrology	ğŸ“€
racing	ğŸ“€
long nose	ğŸ«
beamed pair of quavers	ğŸ«
gun	ğŸ«
diners club	ğŸ«
omkara	ğŸ«
inhale	ğŸ«
retail	ğŸ«
snout	ğŸ«
aussie flag	ğŸ«
tongue	ğŸ«
avocado	ğŸ«
printer	ğŸ«
smiling face with sunglasses	ğŸ«
rat	ğŸ«
blessing	ğŸ«
school	ğŸ«
food	ğŸ¦†
exercise	ğŸ–¥
wc	ğŸ–¥
index card	ğŸ–¥
high voltage sign	ğŸš£ğŸ¼
desert	ğŸš•
moat	ğŸš•
arabian camel	ğŸš•
black white right pointing backhand index	ğŸš•
instrument	ğŸš•
sky	ğŸš•
easter island	ğŸš•
smiling	ğŸš•
parchment	ğŸš•
closet	ğŸ™‹ğŸ¼
white surfer	ğŸ¬
picture	ğŸ¬
twisted rightwards arrows	ğŸ¬
lips sealed	ğŸ¬
daisy	ğŸ¬
color	ğŸ¬
smoke	ğŸ¬
white man with turban	ğŸ¬
smiling face with open mouth	ğŸ¬
greek	ğŸ‘
nature	ğŸ‘
tropical	ğŸ‘
win	ğŸ‘
flexed biceps	ğŸ‘
passion	ğŸ‘
anthropomorphic	ğŸ‘
high	ğŸ‘
weary	ğŸ‘
kitchen knife	ğŸ‘
smiling cat face with open mouth	ğŸ‘
regional indicator symbol letters na	ğŸ‡±ğŸ‡»
white boy	ğŸ‡±ğŸ‡»
burger	ğŸ™ğŸ¼
regional indicator symbol letter v	â±
shooting	ğŸ‡§ğŸ‡»
american express	ğŸ‘§ğŸ¼
djiboutian flag	ğŸ
sign	ğŸ
locomotive	ğŸ
flag for azerbaijan	ğŸ’ 
music	ğŸ’ 
regional indicator symbol letters vg	ğŸ’ 
help	ğŸ’ 
red rose	ğŸ’ 
slot machine	ğŸ’ 
pine decoration	ğŸ’ 
regional indicator symbol letters jm	ğŸ’ 
beverage	ğŸ‘†
meal	ğŸ‘†
flag for christmas island	ğŸ‘†
snake	ğŸ¦
cheese	â¤´ï¸
notebook	ğŸ˜…
dirty	ğŸ˜…
black person with pouting face	ğŸ˜…
olive toned runner	ğŸ˜…
surprised	ğŸ˜…
regional indicator symbol letters ai	ğŸ˜…
black and white book	ğŸ˜…
no drinking water	ğŸ„
clapboard	ğŸ„
britain	ğŸ„
minibus	ğŸ„
kebab	ğŸ„
ramen	ğŸ„
crossed flags	ğŸ„
bike	ğŸ”¹
put litter in its place symbol	ğŸ¤š
no smartphones	ğŸ¤š
yellow	ğŸ‘
toadstool	ğŸ‘
tassel	ğŸ‘
world tour ticket	ğŸ‘
beating heart	ğŸ‘
cry	ğŸ‡¸
white person raising both hands in celebration	ğŸ‡±ğŸ‡°
cowgirl	ğŸ‡±ğŸ‡°
frustrated	ğŸ‘ğŸ¿
regional indicator symbol letters cz	ğŸ“·
cookie	ğŸ“·
bacon	ğŸ•
regional indicator symbol letters jo	ğŸ•
robot	ğŸ•
flag for niger	ğŸ•
bathroom sign	ğŸ•
queen	ğŸ•
suggestive smile	ğŸ•
white person with blond hair	ğŸ•
blowing kiss	ğŸ•
carnival	ğŸ‡²ğŸ‡¼
horse racing	ğŸ‡²ğŸ‡¼
kamboko	ğŸ’Š
clapping	ğŸ’Š
postal horn	ğŸ’Š
oregon	ğŸ’Š
chelonian	â­•
centipede	â­•
exploding star	â­•
cat face with tears of joy	â­•
cancer	ğŸ‘¸ğŸ¾
female	ğŸŒ»
bathroom	ğŸŒ»
pin	ğŸŒ»
left triangle	ğŸŒ»
sports	ğŸŒ»
regional indicator symbol letters cn	ğŸŒ»
bicyclist	ğŸ™†
motorhome	ğŸ™†
waste	ğŸ™†
open mailbox with lowered flag	ğŸ™†
steamed rice	ğŸ™†
couple with heart with two women	ğŸ™†
heart broken	ğŸ™†
vertical	ğŸƒğŸ¾
flat	ãŠ—ï¸
jesus	ğŸ¨
light brown princess	ğŸ¨
sign	ğŸ¨
sleep	ğŸ¨
atm	ğŸ¨
love	ğŸ¨
baby	ğŸ‘ 
zodiac	ğŸ‘ 
open folder	ğŸ‡±ğŸ‡®
crying	ğŸ‡±ğŸ‡®
beef	ğŸ‡·ğŸ‡¸
person in bath	ğŸ‡·ğŸ‡¸
mouth	ğŸ›ƒ
cute	ğŸ›ƒ
turtle	ğŸ›ƒ
winking	ğŸ›ƒ
flag for belgium	ğŸ›ƒ
park	ğŸ›ƒ
diaphoresis	ğŸ›ƒ
regional indicator symbol letters bt	ğŸ‘°ğŸ¾
shoe	ğŸ‡¸ğŸ‡®
boat	ğŸ‡¸ğŸ‡®
snowboard	ğŸˆ¸
roasted	ğŸˆ¸
lunch box	ğŸˆ¸
trackball	ğŸˆ¸
tropical	ğŸ˜™
olive toned raised hand	ğŸ˜™
pink	ğŸ˜™
love	ğŸ˜™
deeper brown bride with veil	ğŸ˜™
oar	ğŸ˜™
helium	ğŸ˜™
flower	ğŸ˜™
finger point	ğŸ˜™
movie	ğŸ˜™
regional indicator symbol letters mr	ğŸ˜™
men	ğŸ”†
duck	ğŸ”†
aries	ğŸ”†
misery	ğŸ‘¥
regional indicator symbol letters np	ğŸ‘¥
orange star	ğŸ‘¥
cheese	ğŸ‘¥
lower left ballpoint pen	ğŸ‘¥
tiredness	ğŸ‘¥
bullock	ğŸ‘¥
malaysian flag	ğŸ‘¥
foot	ğŸ‘¥
trophy	ğŸ‘¥
macbook	ğŸ‘¥
yellow dog	ğŸ’·
astrology	ğŸ’·
surfer	ğŸ’·
regional indicator symbol letters az	ğŸ’·
dvd rom	ğŸ’·
black surfer	ğŸ’·
fork and knife with plate	ğŸ’·
cute	ğŸ’·
flag for western sahara	ğŸ’·
pastry	ğŸ’·
fire	ğŸ’·
shops	ğŸ’·
deeper brown thumbs down sign	â€
Ã¥land flag	ğŸ
regional indicator symbol letters lr	ğŸ
crab cancer	ğŸ
inhale	ğŸ
cute	ğŸ
stars	ğŸ
newborn	ğŸ
power plug	ğŸ
storm	ğŸ
black man	ğŸ
melon	ğŸ
wednesday	ğŸ
flag for brazil	ğŸ’‡ğŸ¿
rail	ğŸ‘Š
heart decoration	ğŸ‘Š
rice cracker	ğŸ‘Š
no mobile phones	ğŸ¼
man	ğŸ¼
older man	ğŸ¼
tree	ğŸ¼
mic	ğŸ¼
church	ğŸ¼
yellow flower	ğŸ¼
email	ğŸ¼
sign	ğŸ¼
emergency	ğŸ¼
golf	ğŸ¼
iowa	ğŸ¼
train	ğŸ¼
emotion	ğŸ‡§ğŸ‡¬
reception bars	ğŸ‡§ğŸ‡¬
red dress woman	ğŸ‡§ğŸ‡¬
puzzle	ğŸ™ğŸ»
light brown person with folded hands	ğŸƒğŸ½
stairs	ğŸ‡¨ğŸ‡·
steam	ğŸ‡¨ğŸ‡·
flag for argentina	â•
clock face nine oclock	ğŸ‘‰ğŸ½
pot	ğŸšŸ
relief	ğŸšŸ
anger sign	ğŸšŸ
brown shoe	ğŸšŸ
upwards black arrow	ğŸšŸ
flag for nicaragua	ğŸšŸ
thumb tack	ğŸ…
golden	ğŸ…
family of two men with two boys	ğŸ…
orange ball	ğŸ…
winners trophy	ğŸ…
woman	ğŸ…
light brown police officer	ğŸ…
olive toned white down pointing backhand index	ğŸ…
summer	ğŸ…
love	ğŸ…
belarusian flag	ğŸ…
flower	ğŸ…
pina	ğŸ…
roasted	ğŸ…
flag for qatar	ğŸ…
bovine	ğŸ‡²ğŸ‡¦
medical	ğŸ‡²ğŸ‡¦
hammer and pick	ğŸ‘¨â€ğŸ‘©â€ğŸ‘¦â€ğŸ‘¦
spaghetti bolognese	ğŸ––ğŸ»
flag for diego garcia	ğŸš¸
residence	ğŸš¸
happiness	ğŸš¸
movie	ğŸš¸
rejected	ğŸš¸
triangle ruler	ğŸš¸
seaweed	ğŸš¸
santa claus	ğŸš¸
heart envelope	ğŸš¸
massive	ğŸš¸
sweet	ğŸ©
white baby angel	ğŸ©
black information desk person	ğŸ©
entry	ğŸ©
hen	ğŸ©
smoking	ğŸ©
hearts	ğŸ©
fax machine	ğŸ©
five	ğŸ©
zodiac	ğŸ©
entertainment	ğŸ©
clean	ğŸ©
pink shirt	ğŸ©
honeybee	ğŸ‡§ğŸ‡§
ring	ğŸ‡§ğŸ‡§
amusement	ğŸ‡§ğŸ‡§
potato	ğŸ‡§ğŸ‡§
brewery	ğŸ„ğŸ¿
bicycle	â›…
makeup	ğŸ”€
regional indicator symbol letters by	ğŸŒ³
ladies	ğŸŒ³
machine	ğŸŒ³
light brown man with turban	ğŸŒ³
evergreen	ğŸŒ³
city sunset	ğŸŒ³
can	ğŸŒ³
paw	ğŸ‡¨ğŸ‡©
cancan	ğŸ¬
headwear	ğŸ¬
refresh icon	ğŸ¬
indian food	ğŸ¬
pocket ball	ğŸ¬
night	ğŸ‘·ğŸ¾
mans shoe	ğŸ‘¦
cigarette	ğŸ„
avatar	ğŸ„
green snake	ğŸ„
fed up	ğŸ„
blank	ğŸ„
jolly	ğŸ„
transport	ğŸ„
flag for grenada	ğŸ’
biohazard sign	ğŸ’
barber pole	ğŸ’
pollen	ğŸ’
regional indicator symbol letters cr	ğŸ’
loo	ğŸ€„ï¸
smiling face with open mouth and cold sweat	ğŸš­
sky	ğŸš­
lava	ğŸš­
ringer disabled	ğŸš­
hoop	ğŸš­
pooh	ğŸš­
bag	ğŸš­
white waving hand sign	ğŸš­
wastebasket	ğŸš­
row	ğŸš­
smiling	ğŸ˜
american football	ğŸ˜
deeper brown police officer	ğŸ˜
dairy	ğŸ˜
cop	ğŸ˜
exit	ğŸ˜
ears	ğŸ™ğŸ¾
viewing	ğŸš
constellation	ğŸš
adventure	ğŸš
pink	ğŸš
young	ğŸš
pig face	ğŸš
happy	ğŸ‘‚ğŸ»
fat	ğŸ‡¬ğŸ‡®
archery	ğŸ‡¬ğŸ‡®
flag for hungary	ğŸ“—
pregnant lady	ğŸ‡¨ğŸ‡¼
trolley	ğŸ‡¨ğŸ‡¼
bulgarian flag	ğŸ‡¨ğŸ‡¼
laps	ğŸ®
stew	ğŸ®
regional indicator symbol letters lc	ğŸ®
grinning face with smiling eyes	ğŸ®
costume	ğŸ®
timid lion	ğŸ®
moon	ğŸ®
sleepy	ğŸ®
neutral face	ğŸ®
stars	ğŸ®
circus	ğŸ®
girlfriends	ğŸŒ¬
classic	ğŸŒ¬
flag for netherlands	ğŸŒ¬
girl	â—¾
say	â™ï¸
park	â™ï¸
unamused face	â™ï¸
fish	â™ï¸
flag for mongolia	â™ï¸
soft serve	â™ï¸
end	â™ï¸
regional indicator symbol letters hn	â™ï¸
delivery	ğŸ‡²ğŸ‡µ
two hearts	ğŸ‡²ğŸ‡µ
smooch	ğŸ‘ŒğŸ¿
squared cool	ğŸ‡­ğŸ‡·
sad tears	ğŸ‡­ğŸ‡·
secret	ğŸ‡­ğŸ‡·
level up	ğŸ‘¯
black rowboat	ğŸ‘¯
hand with first and second fingers crossed	ğŸ‘¯
fuel pump	ğŸ‘¯
christmas	ğŸ‘¯
down	ğŸ‘¯
norfolk island flag	ğŸ‘¯
taxicab	ğŸ‘¯
æœ‰	ğŸ‘¯
nicotine	ğŸ‘¯
bathroom	ğŸ‘¯
tanabata	ğŸ‘¯
deeper brown bath	ğŸ­
pie	â¿
fish	â¿
happy	â¿
food	ğŸ‡«ğŸ‡²
think	âŒšï¸
joker card	ğŸ˜¦
cross	ğŸ˜¦
fox face	ğŸ˜¦
olive toned clapping hands sign	ğŸ˜¦
bar	ğŸ˜¦
theater	ğŸ˜¦
triumph	ğŸ˜¦
purchase	ğŸŒŒ
here	ğŸŒŒ
malt	ğŸŒŒ
astrology	ğŸŒŒ
girl	ğŸŒŒ
screw	ğŸŒŒ
harvest	ğŸŒŒ
gem stone	ğŸŒŒ
white father christmas	ğŸŒŒ
ball	ğŸŒŒ
persevere	ğŸ‘ŠğŸ¾
flag for norway	ğŸ’¦
monkey covering mouth	ğŸ’¦
occidental	ğŸ’¦
sign	ğŸ’¦
anthropomorphic	ğŸ‘©â€ğŸ‘©â€ğŸ‘¦â€ğŸ‘¦
female	ğŸ¸
team	ğŸ¸
full	ğŸ¸
fire engine	ğŸ¸
olive toned person with blond hair	ğŸ¸
regional indicator symbol letters uy	ğŸ¸
school	ğŸ¸
flag for switzerland	ğŸ¸
below zero	ğŸ¸
rail	ğŸ¸
woman	ğŸ¸
waxing gibbous moon symbol	ğŸ—¨
foot guard	ğŸ‰
thumbs down sign	ğŸ‰
knife and fork	ğŸ‰
wild boar	ğŸ‰
moon	ğŸ‰
sale	ğŸ‰
regional indicator symbol letters sz	ğŸ‰
joy	ğŸ‰
new	ğŸ‰
waxing	ğŸ‘¨â€ğŸ‘¨â€ğŸ‘§â€ğŸ‘§
zig zag bubble	â³
quarter	â›“
regional indicator symbol letters bm	ğŸ‘¸ğŸ»
race	âœˆï¸
dark moon face	âœˆï¸
bullet	âœˆï¸
vase	âœˆï¸
disappointed face	âœˆï¸
cigarette	âœˆï¸
sign	âœˆï¸
greek	âœˆï¸
flag for faroe islands	âœˆï¸
tsukimi	âœˆï¸
ball	âœˆï¸
european	âœˆï¸
banzai	âœˆï¸
ballonfish	ğŸ” 
bugle	ğŸ” 
rotary phone	ğŸ” 
critter	ğŸª
leaves	ğŸª
fencer	ğŸª
on with exclamation mark with left right arrow above	ğŸª
dog	ğŸª
homosexual	ğŸª
ufo	ğŸª
home	ğŸª
snow capped mountain	ğŸª
caring	ğŸª
flag for chile	ğŸª
pencil and paper	ğŸª
halo	ğŸª
envelope	ğŸª
light brown father christmas	ğŸª
diesel train	ğŸª
rolling on the floor laughing	ğŸ™†ğŸ»
deciduous tree	*âƒ£
centaur	ğŸ˜
dragon face	ğŸ±
star of david	ğŸ±
gem	ğŸ±
glower	ğŸ±
soon with rightwards arrow above	ğŸ±
key	ğŸ±
sex	ğŸ±
monorail	ğŸ±
stadium	ğŸ±
carp streamer	ğŸ±
moon	ğŸ’…
speech	ğŸ’…
celebrate	ğŸ’…
police	ğŸ’…
mr whippy	ğŸ“†
shibuya 109 department store	ğŸ“†
reptile	ğŸ›´
white fisted hand sign	ğŸŒ“
fist bump	ğŸŒ“
needle	ğŸŒ“
olive toned raised hand with part between middle and ring fingers	ğŸŒ“
evening	ğŸŒ“
airplane departure	ğŸŒ“
bell with cancellation stroke	ğŸŒ“
tent	ğŸŒ“
paper	ğŸ–
easter bunny	ğŸ¤º
skittles	ğŸ•™
steam	ğŸ¥
american	ğŸ¥
multiple musical notes	ğŸ¥
white sun behind cloud with rain	ğŸ¥
shrug	ğŸ¥
regional indicator symbol letter n	ğŸ¥
shocked face	ğŸ¥
flag for moldova	ğŸ¥
lol	ğŸ¥
black runner	ğŸ˜ˆ
person with blond hair	ğŸ˜ˆ
railroad car	ğŸ˜ˆ
film slate	ğŸ˜ˆ
clock face five oclock	ğŸ˜ˆ
star	ğŸ˜ˆ
soak	ğŸ˜ˆ
hot	ğŸ˜ˆ
white person bowing deeply	ğŸ˜ˆ
nervous	ğŸš¶ğŸ½
air quotes	ğŸ“³
pepsi	ğŸ“³
sex	ğŸ“³
whistle	ğŸ‘€
olive toned baby angel	ğŸ‘€
foreign	ğŸ‘€
welcome	ğŸ‘€
red cross	ğŸ‘€
skewer	ğŸ‘€
flag for sweden	ğŸ
cash	ğŸ
console	ğŸ
space	ğŸ
train	ğŸ
dollar	ğŸ
alpine	ğŸ
needles	ğŸ›£
hearty	ğŸ›£
endure	ğŸ›£
deutsch flag	ğŸ›£
family of two women with one girl and one boy	ğŸŒ‚
light	ğŸŒ‚
frowning face with open mouth	ğŸŒ‚
train	ğŸŒ‚
small hearts	ğŸŒ‚
tangerine	ğŸŒ‚
snowman without snow	ğŸŒ‚
sleep face	ğŸŒ‚
rose	ğŸŒ‚
negative squared latin capital letter b	ğŸŒ‚
star	ğŸŒ‚
eiffel tower	ğŸˆ‚ï¸
heart	ğŸ‡¹ğŸ‡¹
lips	ğŸ‡»ğŸ‡¦
person on bike	ğŸŒ·
cheese	ğŸŒ·
regional indicator symbol letter q	ğŸŒ·
light brown surfer	ğŸŒ·
frown	ğŸŒ·
violet	ğŸ“µ
fugu	ğŸ“µ
blooper	ğŸ“µ
bull	ğŸ“µ
perplex	ğŸ‡¬ğŸ‡µ
japanese lantern	ğŸ‡¬ğŸ‡µ
kosovar flag	ğŸ‡¬ğŸ‡µ
standard poodle	ğŸ°
flag for cameroon	ğŸ°
court	ğŸ°
speaker with one sound wave	ğŸ°
kitty	ğŸ°
family of two men with one girl and one boy	ğŸ°
gay	ğŸ°
ghost	ğŸ˜
house	ğŸ˜
black white down pointing backhand index	ğŸ˜
shaking hands	ğŸ˜
child	ğŸ˜
high five	ğŸ˜
identification	â”
autumn leaves	ğŸ‡µğŸ‡ª
large blue circle	ğŸ‡µğŸ‡ª
banknote	âŒ›ï¸
regional indicator symbol letters tv	ğŸ‡¸ğŸ‡²
up triangle	ğŸ‡¸ğŸ‡²
kiss	ğŸ‡¦ğŸ‡´
skinny	ğŸ‡¦ğŸ‡´
romance	4ï¸âƒ£
credit card	ğŸ™
audio	ğŸ‡¯
berry	ğŸ’¤
astronaut	ğŸ’¤
wish tree	ğŸ’¤
regional indicator symbol letters hk	ğŸ’¤
wide eyes	ğŸ’¤
yay	ğŸ™‡ğŸ¾
light brown guardsman	ğŸ—‚
earth	ğŸ—½
truck	ğŸ—½
lock and pen	ğŸ‡¨ğŸ‡®
sign	ğŸª
honor	ğŸª
bungalow	ğŸª
spring	ğŸª
smoking	ğŸª
happy	ğŸª
regional indicator symbol letters ae	ğŸª
show	ğŸª
plumbing	ğŸª
joint	ğŸ”•
sports	ğŸ”•
cat face with wry smile	ğŸ”•
cocktail	ğŸš¬
flag for palau	ğŸš¬
left luggage	ğŸš¬
white happy person raising one hand	ğŸš¬
stars	ğŸš¬
worried face	ğŸš¬
seed	ğŸš¬
ice skate	ğŸš¬
talk	ğŸš¬
train	ğŸ˜¨
float	ğŸ˜¨
assistance	ğŸ˜¨
newspaper delivery	ğŸ˜¨
sad	ğŸ˜¨
phase	ğŸ˜¨
light	ğŸ’‹
new moon symbol	ğŸ’‹
bahrainian flag	â‰ï¸
backstroke	ğŸ†
peace sign	ğŸ†
bank	ğŸ†
frog face	ğŸ†
grevenstein apple	ğŸ†
night	ğŸ†
desert	ğŸ†
sick	ğŸ†
regional indicator symbol letter l	ğŸ†
die	ğŸ†
cheese wedge	ğŸ†
sheet music	ğŸ’ğŸ½
barley	ğŸš±
white small square	ğŸš±
japanese dress	ğŸš±
octagonal sign	ğŸš±
tumbler glass	ğŸš±
egg	ğŸš±
leo	ğŸš±
gas	ğŸš±
balloon	ğŸ‡»ğŸ‡³
sign	ğŸ‡»ğŸ‡³
butter	ğŸšŒ
minidisc	ğŸšŒ
subway	ğŸšŒ
new years	ğŸšŒ
grinning face	ğŸšŒ
flag for taiwan	ğŸšŒ
no entry	ğŸ‡±ğŸ‡¸
turkey	ğŸ‡±ğŸ‡¸
shadows	ğŸ‘‚ğŸ¾
light brown raised hand	ğŸ”’
flag for american samoa	ğŸ”’
car	ğŸ”’
smiling face with smiling eyes	ğŸ‘²
grinning	ğŸ‘²
mountain	ğŸ‘²
heart	ğŸ‘²
regional indicator symbol letters pr	ğŸ‘²
spice	ğŸ‘²
drive	ğŸ‘œ
nerdy	ğŸ‘œ
spider	â˜ï¸
staff	ğŸ‡²ğŸ‡´
facepalm	ğŸ‡²ğŸ‡´
frustrated	ğŸ‘´ğŸ¾
shibuya	ğŸ‘°ğŸ½
flag for lesotho	ğŸ“®
friends	ğŸ¸
black guardsman	ğŸ¸
sign	ğŸ¸
dogeza	ğŸ˜‡
cake	ğŸ˜‡
flag for kuwait	ğŸ˜‡
sad	ğŸ˜‡
tower	ğŸ˜‡
scales	ğŸ˜‡
sunflower	ğŸ‘«
number 10	ğŸ‘«
scorpion	ğŸ‘«
moving	ğŸ‘«
wind	ğŸš¶ğŸ»
automobile	ğŸŠ
deeper brown mountain bicyclist	ğŸŠ
closed lock	ğŸŠ
gifts	ğŸŠ
passenger train	ğŸŠ
mrs claus	ã€½ï¸
teacup	ã€½ï¸
wet	ã€½ï¸
flag for monaco	ã€½ï¸
norwegian flag	ã€½ï¸
magma	ã€½ï¸
london	ã€½ï¸
mark	ã€½ï¸
chimney	ã€½ï¸
crossed swords	ã€½ï¸
appreciation	ğŸ‘ğŸ½
account	ğŸ
cowboy	ğŸ
archer	ğŸ
wild cherry	ğŸ
august	ğŸ
magnify	ğŸ–‹
flag for tonga	ğŸ‘¦ğŸ¾
poodle	ğŸ£
greek	ğŸ£
black bride with veil	ğŸ£
prayer beads	ğŸ’«
flag for romania	ğŸ’«
gypsy	ğŸ’«
lesbian couple	ğŸ’«
pisces	ğŸ’«
disappoint	ğŸ’«
eek	ğŸ’«
square	ğŸ’«
regional indicator symbol letter e	ğŸ’«
constellation	ğŸ¹
seeds	ğŸ¹
cream	ğŸ¹
okay	ğŸ¹
smiley face	ğŸ¹
nicotine	ğŸ¹
book	ğŸ¹
handset	ğŸƒğŸ¼
sea	ğŸ¥’
stop	ğŸ¥’
hand	ğŸ¥’
tengu	ğŸœ
weather	ğŸˆ
heat	ğŸˆ
merry go round	ğŸˆ
baby	ğŸ“‹
flag for micronesia	ğŸŒŸ
light brown person bowing deeply	ğŸŒŸ
screaming cat	ğŸŒŸ
flag for canary islands	ğŸŒŸ
regional indicator symbol letters bd	ğŸŒŸ
warm	ğŸŒŸ
paper doily	ğŸŒŸ
astrology	ğŸŒŸ
white medium small square	ğŸŒŸ
cold	ğŸŒŸ
a	ğŸ’˜
face with tears of joy	ğŸ’˜
yellow bird	ğŸ’˜
stars heart	ğŸ‡¾ğŸ‡ª
heavy large circle	ğŸ‡¾ğŸ‡ª
bird	â›
kid	âº
latin cross	ğŸ‘‡
persevering face	ğŸ‘‡
flag for burkina faso	ğŸ¦
city building	ğŸ¦
kiwi flag	ğŸ¦
night	ğŸ‡°ğŸ‡ª
goblin	ğŸ‡°ğŸ‡ª
film frames	ğŸ‡°ğŸ‡ª
strawberries	ğŸ›Œ
maiden	ğŸ…°ï¸
flag for mozambique	7âƒ£ï¸
flag for tristan da cunha	ğŸ™ˆ
pink umbrella	ğŸ™ˆ
eyes	ğŸ™ˆ
supernatural	ğŸ™ˆ
baby symbol	ğŸ™ˆ
cross mark	ğŸ™ˆ
scrunched eyes	ğŸ™ˆ
deeper brown runner	ğŸ™ˆ
regional indicator symbol letters to	ğŸ
worried	ğŸ
moon	ğŸ
beer	ğŸ˜‹
transportation	ğŸ˜‹
butterflies in stomach	ğŸ˜‹
horse face	ğŸ˜‹
dango	ğŸ˜‹
clock face four oclock	ğŸ˜‹
sign	ğŸ˜‹
fog	ğŸ˜‹
kiss	ğŸ˜‹
white princess	ğŸ˜‹
short	ğŸ˜‹
deeper brown person bowing deeply	â£
regional indicator symbol letters vn	â£
hand wave	ğŸ‘¸
scary	ğŸ‘¸
not	ğŸ‘¸
fruit	ğŸ‘¸
spring	ğŸ‘¸
thoroughbred	ğŸ‘¸
silhouette of japan	ğŸ‘¸
snow	ğŸ‘¸
crab	ğŸ‘¸
bugs bunny	ğŸ‘¸
ride	ğŸ“²
stars	ğŸ“²
light brown rowboat	ğŸ“²
melon	ğŸ“²
dhikr beads	ğŸ‡¿ğŸ‡¦
flag	ğŸ‡¿ğŸ‡¦
silly	ğŸ‘¼ğŸ»
yam	ğŸ’µ
announcement	ğŸ’µ
female restroom	ğŸ’µ
leaf	ğŸ’µ
craftsman	ğŸ’µ
demon	ğŸ’µ
visa	ğŸ’µ
easy	ğŸ’µ
rail	ğŸ’µ
school	ğŸ’µ
speed	ğŸ’µ
regional indicator symbol letters bs	ğŸ’µ
sky	ğŸ’µ
smiling moon	ğŸ™
big	ğŸ™
hot dog	ğŸ™
birthday	ğŸ™
mask	ğŸ™
bunny	ğŸ™
regional indicator symbol letters gy	ğŸ™
fuel pump	ğŸ™
cross	ğŸ”£
ant	ğŸ”£
cloudless	ğŸ”£
mad face	ğŸ‘¨ğŸ»
sting	ğŸ”„
clothes	ğŸ”„
h20	ğŸ”„
regional indicator symbol letters ga	ğŸŠ
fall	ğŸŠ
heavy exclamation mark symbol	ğŸŠ
formula	ğŸŠ
regional indicator symbol letters ca	ğŸœ
cantaloupe emoiji	ğŸœ
bathers	ğŸœ
blossom	ğŸœ
stroll	ğŸœ
pedal	ğŸœ
shampoo	ğŸ¿
abandoned house	ğŸ¿
om symbol	ğŸ¿
steam train	ğŸ¿
light brown happy person raising one hand	ğŸ¿
crescent	ğŸ¿
pray	ğŸ¿
molester moon	ğŸ¿
constellation	ğŸ¿
encouragement	ğŸ¿
radioactive sign	ğŸ¿
wings	ğŸ¿
lantern	ğŸ¿
dromedary camel	ğŸ”±
black swimmer	ğŸ¤’
tramway	ğŸ¤’
irish	ğŸ¤’
flag for puerto rico	ğŸ‘®ğŸ¼
harvest moon	ğŸ•
cheeky monkey	ğŸ•
cue	ğŸ˜¤
put litter in trash	ğŸ˜¤
flag for uganda	ğŸ˜¤
regional indicator symbol letters iq	ğŸ˜¤
maple leaf	ğŸ˜¤
sun	ğŸ˜¤
peperoni	ğŸ˜¤
tears	ğŸ˜¤
bam	â™
footsteps	â™
ok hand sign	â™
aa battery	â™
pot of food	â™
â„¹ help icon	â™
heavy plus sign	â™
keycap digit nine	â™
holding	â™
writing hand	ğŸ‡¨ğŸ‡½
princess	ğŸ‡¨ğŸ‡½
cheering megaphone	ğŸ“¤
light brown flexed biceps	ğŸ“¤
hands	ğŸ‡§ğŸ‡­
closed	ğŸ‡§ğŸ‡­
pedestrian	ğŸ‡§ğŸ‡­
light brown open hands sign	ğŸ‡§ğŸ‡­
face with medical mask	ğŸ˜Œ
shoot	ğŸ˜Œ
sob	ğŸ˜Œ
shooting star	ğŸ˜Œ
light	ğŸ˜Œ
phase	ğŸ˜Œ
guamanian flag	ğŸ˜Œ
troll	ğŸ‘ŒğŸ»
paint	âœ¨
classical building	âœ¨
lipstick	âœ¨
waving white flag	ğŸ—¡
tennis racket	ğŸ—¡
light brown man	ğŸª
ceremony	ğŸª
victory	ğŸª
steam locomotive	ğŸª
electronics	ğŸª
man with gua pi mao	ğŸª
animal	ğŸ’ƒğŸ»
vain	â™‹
butchers knife	â™‹
regional indicator symbol letter g	â™‹
honest	â™‹
flag for gambia	â™‹
tv	â™‹
accommodation	â™‹
umbrella	â™‹
oink	ğŸ“¿
bug	ğŸ“¿
black face with ok gesture	ğŸ“¿
like	ğŸ‘ğŸ»
mosque	ğŸ‡¦ğŸ‡¹
lion	ğŸ‡¦ğŸ‡¹
losing money	ğŸ‡¦ğŸ‡¹
speedboat	ğŸ‡´ğŸ‡²
flag for seychelles	ğŸ‡´ğŸ‡²
friendship	ğŸ’‡ğŸ¾
lips	ğŸ†
turkey	ğŸ†
play	ğŸ†
sun	ğŸ†
red delicious apple	ğŸ†
sun	ğŸ†
flag for new zealand	ğŸ†
electric torch	ğŸ†
regional indicator symbol letters bn	ğŸ†
black medium small square	ğŸ†
cooked rice	ğŸ‘‡ğŸ¼
pear	ğŸ‘‰ğŸ¼
reflective	ğŸ˜¡
sunrise	ğŸ˜¡
doorway	ğŸ˜¡
relieved	ğŸ˜¡
wind chime	ğŸ˜¡
two	ğŸ˜¡
currency	ğŸ˜¡
ear	ğŸ˜¡
good luck	ğŸ˜¡
morning	â—ï¸
punch	ğŸŠ
pray	ğŸŠ
umbrella with rain drops	ğŸŠ
direct	ğŸŠ
flag for uzbekistan	ğŸŠ
afghan flag	ğŸŠ
tick	ğŸŠ
lying face	ğŸŠ
farris	ğŸŠ
clear button	ğŸŠ
currency exchange	ğŸ‡¹ğŸ‡°
wrapped present	âœ‹ğŸ¾
bearer	ğŸ‡¬ğŸ‡¹
busts in silhouette	ğŸ‡¬ğŸ‡¹
moon viewing ceremony	ğŸ”¬
ç„¡	ğŸ”¬
shrimp	ğŸ”¬
sky	â›„ï¸
no bikes sign	â­ï¸
cell phone	ğŸ˜
flu	ğŸ˜
sweat	ğŸ˜
flag for tajikistan	ğŸ˜
eye roll	ğŸ˜
autumn	ğŸ˜
impish	ğŸ˜
cocktail	ğŸ˜
black heart suit	ğŸ˜
clean	ğŸ› 
baseball	ğŸ’¿
railway	ğŸ’¿
bust in silhouette	ğŸ’¿
bicep	ğŸ’¿
olive toned swimmer	ğŸ”«
citrus	ğŸ”«
boy	ğŸ”«
sky	ğŸ°
single eye	ğŸ°
authority	ğŸ°
white question mark ornament	ğŸ°
heartbeat	ğŸ°
question	ğŸ°
rail	ğŸ°
rural	ğŸ°
ship	ğŸ°
phase	ğŸ°
x	ğŸ°
guard	ğŸ°
golden delicious apple	ğŸ°
regional indicator symbol letters in	ğŸ°
ice hockey stick and puck	ğŸ°
grin	ğŸ°
greek	ğŸ°
top with upwards arrow above	ğŸ°
space	ğŸ°
flag for angola	ğŸ°
compact disc	ğŸ’’
tease	ğŸ’’
special	ğŸ’’
person	ğŸ’’
croatian flag	ğŸ‡¯ğŸ‡µ
australia	ğŸ‡¯ğŸ‡µ
four	ğŸ‡¯ğŸ‡µ
restaurant	ğŸ¤
meal	ğŸ¤
lollipop	ğŸ¤
nigerian flag	ğŸ¤
dog face	ğŸ¤
no	ğŸ¤
fork and knife	ğŸ¤
stars	ğŸ¤
flag for namibia	ğŸ¤
showy	ğŸ¦ˆ
magic	ğŸ¦ˆ
water	ğŸ’…ğŸ¿
squid	ğŸ”
regional indicator symbol letters ma	ğŸ”
tired	ğŸ”
tear	ğŸ”
syringe	ğŸ”
doge	ğŸ”
regional indicator symbol letters gi	ğŸ”
flagpole	ğŸ‘•
bear	ğŸ‘•
regional indicator symbol letter w	ğŸ˜¬
gown	ğŸ˜¬
pouch	ğŸ˜¬
roadwork	ğŸ˜¬
coaster	ğŸ˜¬
light brown horse racing	ğŸ˜¬
farming	ğŸ˜¬
thumbs down	ğŸ˜¬
harbor	ğŸ”‹
mug	ğŸ”‹
flag for greece	ğŸ”‹
ram	ğŸ“Ÿ
full moon symbol	ğŸ“Ÿ
first quarter moon with face	ğŸ“Ÿ
dislike	ğŸ‘ˆğŸ½
strike	ğŸ‡ğŸ¾
abc	ğŸ‡¬ğŸ‡³
spectrum	ğŸ‡¬ğŸ‡³
prosperity	ğŸ‡µğŸ‡¼
dribble	ğŸ‡µğŸ‡¼
sake	ğŸ’ªğŸ½
light brown raised hand with part between middle and ring fingers	ğŸšˆ
hollywood	ğŸšˆ
surprise	ğŸšˆ
spend	ğŸšˆ
slow	ğŸ›€
increase brightness	ğŸ›€
hug	ğŸ›€
hanafuda	ğŸ›€
central asia	ğŸ›€
music	ğŸ›€
idea	ğŸ›€
hit	ğŸ›€
scorpio	ğŸ›€
keyboard	ğŸ›€
train	ğŸ›€
astrology	ğŸ›€
cat	ğŸ›€
approval	ğŸ›€
fairground	ğŸ›€
bell	ğŸš—
water polo	ğŸš—
congratulations	ğŸš—
regional indicator symbol letters er	ğŸš—
soap	ğŸš—
regional indicator symbol letters am	ğŸ“„
anchor	ğŸ“„
bathtub	ğŸ™ğŸ¼
gay pride	ğŸ‚
sunset	ğŸ‚
fiddle	ğŸ‚
sexual face	ğŸ‚
white horse racing	ğŸ‚
sight	ğŸ‚
hot springs	ğŸ‚
ng	ğŸ‚
scorpius	ğŸ‚
no cell phones	ğŸ‹
birth	ğŸ‹
pleased	ğŸ‹
heavy division sign	ğŸ‹
french	ğŸ‹
smiley	ğŸ‹
flag for ecuador	ğŸ‹
british virgin islander flag	ğŸµ
shower	ğŸµ
brush	ğŸµ
motion	ğŸµ
bruneian flag	ğŸµ
sign	ğŸµ
heavy exclamation mark symbol	ğŸµ
pisces	ğŸ’‡
heavy multiplication x	ğŸ’‡
greek	ğŸ’‡
sky	ğŸ‘ğŸ½
notebook	ğŸ†
flag for haiti	ğŸ†
man and woman kissing	ğŸ†
first quarter moon symbol	ğŸ†
insect	ğŸ†
ski and ski boot	ğŸ†
v sign	ğŸ†
sign	ğŸ
smoke	ğŸ
pensive	ğŸ
fruit	ğŸ
french	ğŸ
black man with turban	ğŸ
palm tree	ğŸ
lolly	ğŸ
blue heart	ğŸ
shroom	ğŸ
water	ğŸ
archery	ğŸ
wish	ğŸ
victory hand	ğŸ
bubble	ğŸ
constellation	ğŸ‡ªğŸ‡º
love	ğŸ‡ªğŸ‡º
grumpy face	ğŸ‡ªğŸ‡º
weather	âŒš
bark	âŒš
regional indicator symbol letters sy	âŒš
spock	âŒš
olive toned horse racing	ğŸ€
grass	ğŸ€
tree	ğŸ€
lion face	ğŸ€
constellation	ğŸ€
car	ğŸŒ«
double bump camel	ğŸ‡«ğŸ‡¯
baggage	ğŸ‡«ğŸ‡¯
alcohol	ğŸ‡®ğŸ‡¨
cooking	ğŸ‘˜
black baby angel	ğŸ‘˜
two hearts	ğŸ‘˜
color	ğŸ‘¨â€ğŸ‘¨â€ğŸ‘¦
water	ğŸ’‚ğŸ¿
regional indicator symbol letters bi	ğŸ
andorran flag	ğŸ‡¾ğŸ‡¹
clear	ğŸ²
department store	ğŸ²
white girl	ğŸ²
clockwise rightwards and leftwards open circle arrows with circled one overlay	ğŸ²
no walking	ğŸ²
people	ğŸ²
scary	ğŸ²
money	ğŸ™Œ
freestyle	ğŸ™Œ
hitting head	ğŸ™Œ
boy and girl kissing	ğŸ™Œ
spicy	ğŸ™Œ
ocean	ğŸ™Œ
front page	ğŸ™Œ
walking	ğŸ™Œ
attitude	ğŸ™Œ
westerner	ğŸ™Œ
thumbs up sign	ğŸ 
white face massage	ğŸ 
yellow woman	ğŸ’£
green heart	ğŸš¤
piggy	ğŸš¤
regional indicator symbol letters lt	ğŸš¤
european flag	ğŸš¤
anxious	ğŸš¤
broken heart	ğŸš¤
crawl	ğŸš¤
silence	ğŸš¤
mahjong tile red dragon	ğŸ•‹
compassion	ğŸ•‹
diamond	ğŸ§
front door	ğŸ§
martiniquais flag	ğŸ§
regional indicator symbol letters ba	ğŸ§
ocean	ğŸ‘µğŸ½
blond	ğŸ‘ğŸ¾
regional indicator symbol letters mz	ğŸ‘‹ğŸ¾
constellation	ğŸ‡®ğŸ‡¹
olive toned nose	ğŸ‡®ğŸ‡¹
humpback whale	ğŸ‡®ğŸ‡¹
cherub	ğŸ’®
ç”³	ğŸ’®
love	ğŸ’®
top hat	ğŸ’®
red flower	ğŸ’®
park	ğŸ’®
yen note	ğŸ’®
artist	ğŸ’®
deeper brown surfer	ğŸ’®
stub	ğŸ’®
girls	ğŸ’®
female	ğŸ’®
rich	ğŸ’®
roast	ğŸ’®
pack	ğŸ’®
unity	ğŸ’®
nervous	ğŸ‡²ğŸ‡¹
sport	ğŸ‡²ğŸ‡¹
egg	ğŸ‡²ğŸ‡¹
ramen	â™‘ï¸
alien	â™‘ï¸
basin	â™‘ï¸
jumbo	â™‘ï¸
stars	â™‘ï¸
megaphone	â™‘ï¸
smile	â™‘ï¸
envelope with lines	ğŸµ
neutral	ğŸµ
green face	ğŸ‘¨ğŸ½
flag for georgia	â›½ï¸
smiley	â›½ï¸
video game	ğŸ“«
face with cowboy hat	ğŸ¦
cheers	ğŸ¦
college	ğŸ¦
black police officer	ğŸ¦
winky face	ğŸ¦
yogurt	ğŸ¦
hike	ğŸ¦
currency	ğŸ¦
lip gloss	ğŸ¦
spectacles	ğŸ¦
galaxy	ğŸ¦
thank you	ğŸ¦
open lock	ğŸ¦
pill	ğŸ¹
uk flag	ğŸ¹
olive toned raised fist	ğŸ¹
snow cone	ğŸ¹
entertainment	ğŸ¹
sheep	ğŸ¹
cloud with tornado	ğŸ¹
regional indicator symbol letters sb	ğŸ¹
canvas	ğŸ¹
baby chick	ğŸ¹
curled page	ğŸ¹
avian	ğŸ¹
no	ğŸ‡µğŸ‡¹
flag for austria	ğŸ‡µğŸ‡¹
handbag	ğŸ‘§
white square button	ğŸ’œ
twilight	ğŸ’œ
regional indicator symbol letters cd	ğŸ’œ
friendship	ğŸ’œ
shield	ğŸ’œ
crescent moon	ğŸ’œ
low brightness symbol	ğŸ’œ
cha cha	ğŸ’œ
leftwards black arrow	ğŸ’œ
emphasis	ğŸ’œ
white	ğŸ’œ
bowl	ğŸ’œ
no	ğŸ’œ
digger	ğŸ’œ
tongue	ğŸµ
whisper	ğŸ‘©ğŸ¿
sky	ğŸ”Ÿ
somber	ğŸ”Ÿ
flag for italy	ğŸ‡¦ğŸ‡ª
buzz	ğŸ‡¦ğŸ‡ª
tropical island	ğŸ™ŒğŸ¼
football	ğŸ‡±ğŸ‡·
glowing star	ğŸ‡±ğŸ‡·
airport	ğŸ•
relieved face	ğŸ•
spare	ğŸ•
mother	ğŸ•
vomit	ğŸ•
lace	ğŸ•
enter	ğŸ•
moon	ğŸ•
loan	ğŸ•
olive toned thumbs down sign	ğŸ¤
tango	ğŸ¤
pit	ğŸ¤
cook	ğŸ”½
hovering man	ğŸ†
chicken	ğŸ†
maple	ğŸ†
silly	ğŸ†
stargazing	ğŸ†
å‰²	ğŸ†
pasta	ğŸ—
freezing	ğŸ‡¼
milk	ğŸ‡³ğŸ‡´
cockerel	ğŸ‡³ğŸ‡´
blonde girl	ğŸ‡³ğŸ‡´
happy face	ğŸ‘¼
sailor	ğŸ‘¼
joy	ğŸ‘¼
five hand	ğŸ‘¼
poultry	ğŸ‘¼
toy poodle	ğŸ‘¼
fort	ğŸ‘¼
verbalize	ğŸ‘¼
fog	ğŸ‡¹ğŸ‡¿
single bump camel	ğŸ‡¹ğŸ‡¿
anthropomorphic	â˜ï¸
curly loop	â˜ï¸
smiley face	â˜ï¸
garbage	ğŸ•‘
constellation	ğŸ°
video	ğŸ°
phase	ğŸ°
no bicycles	ğŸ°
autumn	ğŸ°
royalty	ğŸ°
color	ğŸ°
black clapping hands sign	ğŸ°
horse	ğŸ°
unique	ğŸ°
israeli flag	ğŸš»
can	ğŸš»
friend	ğŸš»
paddle	ğŸš»
woodwind	ğŸš»
stars	ğŸš»
cricket	ğŸš»
bus	ğŸš»
french southern lands flag	ğŸš»
ping pong	ğŸš»
dairy cow	ğŸ‘’
white ear	ğŸ‘’
dancers	ğŸ‘’
kissing	âš±
glyph	ğŸŒ¿
thinking face	ğŸŒ¿
negative squared latin capital letter p	ğŸŒ¿
zodiac	ğŸŒ¿
fair	ğŸŒ¿
stars	ğŸŒ¿
flush	ğŸ‡¬ğŸ‡¦
smiley moon	ğŸ‡¬ğŸ‡¦
deeper brown older man	ğŸ‡¬ğŸ‡¦
kiss face	ğŸ“•
cry	ğŸ“•
pout	ğŸ…ğŸ¿
æŒ‡	ğŸ‘±ğŸ½
regional indicator symbol letters se	ğŸ‡°ğŸ‡®
kiss	ğŸ‡°ğŸ‡®
swimsuit	ğŸ‘‹
wrap	ğŸ‘‹
box	ğŸ‘‹
north	ğŸ‘‹
superbowl	ğŸ‘‹
regional indicator symbol letters ie	ğŸˆ¯
happy cow	ğŸˆ¯
baguette bread	ğŸ˜
rail	ğŸ˜
sky	ğŸ˜
emergency	ğŸ˜
shower head	ğŸ˜
videocassette	ğŸ›¬
guitar	ğŸŒ‹
ship	ğŸŒ‹
desire	ğŸŒ‹
head	ğŸŒ‹
camping	ğŸŒ‹
flag for el salvador	ğŸ“
crab	ğŸ“
symbols	ğŸ™ğŸ¿
music	ğŸ’ƒğŸ¿
fly	ğŸ––ğŸ½
bar	ğŸ‘§ğŸ»
curaÃ§aoan flag	ğŸ”Š
wild west	ğŸ”Š
pickle	ğŸ‘ƒğŸ»
flag for singapore	ğŸ™ğŸ¿
foot in mouth	ğŸ™€
sun	ğŸ™€
black open hands sign	ğŸ™€
black raised hand with part between middle and ring fingers	ğŸ™€
national park	ğŸ™€
fox	ğŸ™€
kidding	ğŸ™€
smelling	ğŸ™€
up down arrow	ğŸ™€
mask face	ğŸ™€
depressed	ğŸ™€
restaurant	ğŸ™€
squeans	ğŸ™€
light brown woman	ğŸ™€
users	â—¾ï¸
breaking heart	â–«ï¸
ghoul	âœ³ï¸
regional indicator symbol letters cm	ğŸ‘·ğŸ»
seashell	âš«
flag for northern mariana islands	ğŸ›¤
suspension	ğŸŒƒ
hushed face	ğŸŒƒ
blank look	ğŸŒƒ
medium white circle	ğŸŒƒ
ecuadorian flag	ğŸŒƒ
old key	ğŸŒƒ
exam	ğŸŒƒ
footprints	ğŸŒƒ
bath	ğŸŒƒ
soccer ball	ğŸŒƒ
deeper brown thumbs up sign	ğŸ¿
light brown ear	ğŸ¿
fried shrimp	â›·
ticket	ğŸ‡¹ğŸ‡¼
rail	ğŸ‡­ğŸ‡°
deeper brown waving hand sign	ğŸ‡­ğŸ‡°
respectful	ğŸ’
song	ğŸ’
stars	ğŸ’
man and woman holding hands	ğŸŒ¶
flag for turkey	ğŸŒ¶
stop sign	ğŸŒ¶
pins	ğŸš›
livestock	ğŸš›
seafood	ğŸš›
deeper brown baby angel	ğŸš›
swell	ğŸš›
no pedestrians	ğŸš›
kissing cat	ğŸš›
waning crescent moon symbol	ğŸ“£
astrology	ğŸ“£
regional indicator symbol letters nz	ğŸ‘¸ğŸ¿
negative squared ab	ğŸ‘Ÿ
city	ğŸ‘Ÿ
orange book	ğŸ‘Ÿ
desert island	ğŸ‘Ÿ
regional indicator symbol letters dz	ğŸ¥™
shinto shrine	ğŸ¥™
mahjong	ğŸ¥™
womans sandal	ğŸ¥™
heavy metal	ğŸ†—
leprechaun	ğŸ†—
flag for liberia	ğŸ†—
smirking cat	ğŸ†—
zzz	ğŸ•¸
web	ğŸ•¸
love	ğŸ•¸
answer	ğŸ‘¶ğŸ»
regional indicator symbol letters mg	ğŸ‘„
italian	ğŸ‘„
phone heart	ğŸ‘„
ears	ğŸ‘„
morning	ğŸ‡¹ğŸ‡³
white information desk person	ğŸ‡¹ğŸ‡³
reborn	âš«ï¸
happy devil	ğŸ›„
golf clap	ğŸ›„
casino	ğŸ›„
stars	ğŸ›„
sprouting	ğŸ›„
regional indicator symbol letters lb	ğŸ”‡
telescope	ğŸ”‡
handbag	ğŸ’†ğŸ½
kiss	ğŸ‡¦ğŸ‡«
city	ğŸ‡¦ğŸ‡«
male	ğŸ‡¦ğŸ‡«
white mountain bicyclist	ğŸ“ƒ
hibiscus	ğŸ“ƒ
trumpet	ğŸ“ƒ
sign	ğŸ—
sweet	ğŸ—
golfer	ğŸ—
depressed	ğŸšµğŸ½
butterfly	ğŸ‡ª
square	ğŸ’¼
farsightedness	ğŸ’¼
roadwork sign	ğŸ‡ºğŸ‡¦
comet	ğŸ‡ºğŸ‡¦
fire	ğŸŒ§
right fist bump	ğŸ€„
temple	ğŸ€„
big wheel	ğŸ€„
teddy bear	ğŸ€„
control	1ï¸âƒ£
city	ğŸ’²
hand up	ğŸ’²
tasting	ğŸ’²
hands on head	ğŸ’²
toddler	ğŸ’²
field hockey	ğŸ’²
light brown person with blond hair	ğŸ’²
slice	ğŸ’²
cheese	ğŸ’²
snot bubble	ğŸ•Œ
goodbye	ğŸ•Œ
thorns	ğŸ•Œ
potato	â˜¢
rail	ğŸ‘ŠğŸ½
india	ğŸ‡²ğŸ‡¬
jazz	ğŸ‡²ğŸ‡¬
frown	â¬›ï¸
strawberry	ğŸš 
bleeper	ğŸš 
signal strength	ğŸš 
travel	ğŸš 
acquire	ğŸš 
deeper brown father christmas	ğŸš 
angry face	â™¨ï¸
acorn	â™¨ï¸
sagittarius	â™¨ï¸
post	ğŸ’Ÿ
lounge	ğŸ‡·ğŸ‡º
clap	ğŸ‡·ğŸ‡º
scales	ğŸ‡·ğŸ‡º
deeper brown woman	ğŸ“’
heart	ğŸ“’
fire truck	ğŸ“’
champagne	ğŸ“’
regional indicator symbol letters tm	ğŸ‡§ğŸ‡¦
string	ğŸ™ğŸ¿
party	ğŸ…
chocolate bar	ğŸ…
taxi	ğŸ…
tennis racquet and ball	ğŸ…
eye	ğŸ…
farm	ğŸ…
space	ğŸ…
vapid	ğŸ›€ğŸ¾
banknote	ğŸ”œ
tada	ğŸ”œ
gate	ğŸ‡¸ğŸ‡¬
slug	ğŸ‡¸ğŸ‡¬
olive toned older woman	ğŸ‘¨â€â¤ï¸â€ğŸ‘¨
sweet	ğŸ£
crab	ğŸ£
smoking symbol	ğŸ£
vcr	ğŸ£
makeup	ğŸ£
one bump camel	ğŸ‘©â€ğŸ‘©â€ğŸ‘¦
beaver	ğŸ‡³ğŸ‡º
x	ğŸ‡³ğŸ‡º
sound	ğŸ‘¼ğŸ¾
virus	ğŸ¼
sacrifice	ğŸ¼
heart	ğŸ¼
stars	ğŸ¼
waving	ğŸ¼
black large square	ğŸ¼
black thumbs down sign	ğŸ¼
bedtime	ğŸ¼
lock and key	ğŸ¼
regional indicator symbol letters me	ğŸ‡µğŸ‡³
regional indicator symbol letters bj	9ï¸âƒ£
highway	ğŸ‡³ğŸ‡¨
rewind	ğŸ‡³ğŸ‡¨
regional indicator symbol letters sk	ğŸ‡³ğŸ‡¨
spades	ğŸ…¿ï¸
flag for suriname	ğŸ“§
smirking	ğŸŒ‡
rice wine	ğŸŒ‡
bus	ğŸŒ‡
december	ğŸŒ‡
masks	ğŸŒ‡
white construction worker	ğŸŒ‡
smiling	ğŸŒ‡
banknote	ğŸŒ‡
pistol	ğŸŒ‡
alpine	ğŸŒ‡
white person with pouting face	ğŸŒ‡
pumpkin	ğŸ“¼
flag for ascension island	ğŸ“¼
sleeping	ğŸ“¼
woof	ğŸ“¼
regional indicator symbol letters pa	ğŸ‡»ğŸ‡ª
claw hammer	ğŸ‡»ğŸ‡ª
hot	ğŸ‡»ğŸ‡ª
military decoration	ğŸ‘¨â€â¤ï¸â€ğŸ’‹â€ğŸ‘¨
three button mouse	ğŸŒ–
console controller	ğŸŒ–
queen	ğŸŒ–
firework	ğŸŒ–
jealous heart	ğŸŒ–
hearts	ğŸŒ–
aerial	ğŸŒ–
eat	ğŸŒ–
demon	ğŸ‡¬ğŸ‡ª
transportation	ğŸ‡¬ğŸ‡ª
male	ğŸ‘‹ğŸ¿
corn	ğŸ‡¹ğŸ‡­
crossing	ğŸ‡¹ğŸ‡­
keycap digit four	ğŸš£ğŸ»
rabbit	ğŸš·
heart	ğŸš·
sandals	ğŸš·
suspension	ğŸš·
stop	ğŸš·
anthropomorphic	ğŸš·
purple heart	ğŸš·
love heart hotel	ğŸš·
light brown baby	ğŸš·
globe	ğŸš·
winter	ğŸ¤¾
oils	ğŸ˜»
speaking	ğŸ˜»
mare	ğŸ˜»
snake	ğŸ˜»
aqua	ğŸ˜»
traffic light	â²
refract	â™¥ï¸
mouth	â™¥ï¸
teach	â™¥ï¸
chick	â™»ï¸
endearment	ğŸ‡¬ğŸ‡¾
karaoke	ğŸ‡¬ğŸ‡¾
regional indicator symbol letters ru	ğŸ‘
trainer	ğŸ‘
water	ğŸ‘
currency	ğŸ‘
camping tent	ğŸ‘
round of applause	ğŸ‘
olive toned surfer	ğŸ‘
regional indicator symbol letters ly	ğŸ‘
serpent	âš—
snowflake	ğŸƒ
pie	ğŸƒ
azerbaijani flag	ğŸƒ
meridian	ğŸƒ
soon	ğŸƒ
anger	ğŸƒ
father	ğŸƒ
micro	ğŸƒ
male	ğŸƒ
nice	ğŸƒ
scape	ğŸƒ
money	ğŸƒ
flag for niue	ğŸƒ
search icon	ğŸƒ
pot	ğŸ‘µ
bread	ğŸ‘µ
billiards	ğŸ‘µ
evergreen tree	ğŸ‘µ
animal	ğŸ‘µ
detail	ğŸ‘²ğŸ¼
sweet potato	ğŸ‘´ğŸ¿
coin bag	ğŸ¤£
haircut	ğŸ¤£
japanese postal mark	ğŸ‡¸ğŸ‡§
chanukiah	ğŸ‡¸ğŸ‡§
heavy check mark	ğŸ‡¸ğŸ‡§
dessert	â›…ï¸
liar	ğŸ¦
red	ğŸ¦
dissatisfied	ğŸ¦
slightly frowning face	ğŸ¦
glasses	ğŸ¦
hurricane	ğŸ¦
race	ğŸ¦
truth	ğŸ™…ğŸ¼
fax	ğŸ‡µğŸ‡¦
black universal recycling symbol	ğŸ‡µğŸ‡¦
fido	ğŸ‘¦ğŸ¿
flag for laos	ğŸ¤¹
holiday	ğŸ•˜
ox	ğŸš¨
red devil	ğŸš¨
nuclear family	ğŸš¨
ultraviolet	ğŸš¨
cute	ğŸš¨
prince	ğŸš¨
flag for kyrgyzstan	ğŸš¨
talk	ğŸš¨
izakaya	â—»ï¸
white heavy tick mark	ğŸŒº
spanner	ğŸŒº
diaper	ğŸŒº
entry	ğŸ‡¹ğŸ‡·
olive toned person raising both hands in celebration	ğŸ‡¹ğŸ‡·
tokyo tower	ğŸ‡¹ğŸ‡·
clock face eight oclock	ğŸ‡½ğŸ‡°
sightsee	ğŸ‡½ğŸ‡°
flag for south africa	ğŸ¦ƒ
sushi	ğŸ¦ƒ
playful	ğŸ¦ƒ
white medium star	ğŸ¦ƒ
fart	ğŸ‡§ğŸ‡¹
game	ğŸ‡§ğŸ‡¹
smiley	âœŠğŸ½
regional indicator symbol letters ls	ğŸ“œ
sky	ğŸ“œ
light brown face massage	ğŸ“œ
eyes	ğŸ¬
camcorder	ğŸ˜
regional indicator symbol letters vu	ğŸ˜
large	ğŸ˜
celebration	ğŸ˜
white face with ok gesture	ğŸ˜
serve	ğŸ˜
traffic	ğŸ˜
yellow book	ğŸ˜
brÃ»lÃ©e	ğŸ‡­ğŸ‡º
deeper brown clapping hands sign	ğŸ‡­ğŸ‡º
light brown man with gua pi mao	ğŸ‘‡ğŸ½
blank face	ğŸ‡²ğŸ‡°
regional indicator symbol letters st	ğŸ‡²ğŸ‡°
sound	ğŸ˜±
voicemail	ğŸ˜±
flag for morocco	ğŸ˜±
candelabrum	ğŸ˜±
narutomaki	ğŸ˜±
tiger	ğŸ˜±
jaws	ğŸ˜±
powder	ğŸ‰
food	ğŸ‰
angry face	ğŸ‰
fire	â˜¦
regional indicator symbol letter u	ğŸ£
happy face	ğŸ£
night	ğŸ£
magnifier	ğŸ£
constellation	ğŸ£
tea	ğŸ£
puckered	ğŸ£
shadow	ğŸ”´
fair	ğŸ¤•
tongue out	ğŸ¤•
devil horns	ğŸ¤•
flag for jamaica	ğŸ’¸
butterfly	ğŸ’¸
black person with blond hair	ğŸ’¸
male dancer	ğŸ’¸
skis	ğŸ’¸
flag for Ã¥land islands	ğŸ’¸
light brown construction worker	ğŸ’¸
baby change symbol	ğŸ’¸
corn on the cob	ğŸ’¸
playful	ğŸ’¸
heart with arrow	ğŸ’¸
emergency	ğŸ’¸
mixed	ğŸ’¸
shadow	ğŸ’¸
deeper brown man with gua pi mao	ğŸ‘¨â€ğŸ‘©â€ğŸ‘§â€ğŸ‘¦
fingers crossed	ğŸ‡©ğŸ‡¯
members	ğŸ‡©ğŸ‡¯
white open hands sign	ğŸ‡©ğŸ‡¯
sakura	ğŸ‡©ğŸ‡¯
flower playing cards	ğŸ¼
bellhop	ğŸ¼
lights	ğŸ¼
cheese	ğŸ¼
storage	ğŸ¼
rail	ğŸ¼
citation	ğŸ¼
credit	ğŸ¼
cute tiger	ğŸ¼
hard	ğŸ’§
strong	ğŸ’§
bag	ğŸ’§
not amused	ğŸ’§
person bowing deeply	ğŸ’§
light brown face with ok gesture	ğŸ’§
flower	ğŸ’§
sky	ğŸ’§
soft ice cream	ğŸ’§
sad devil	ğŸ’§
bulb	ğŸ’§
chart with upwards trend and yen sign	ğŸ’§
kissing	ğŸ’§
america	0ï¸âƒ£
dollar sign eyes	ãŠ™ï¸
fortified	ğŸµ
tub	ğŸµ
wow	ğŸµ
black small square	ğŸµ
face	ğŸµ
black face massage	ğŸµ
middle finger	ğŸµ
zero width joiner	ğŸµ
pink swirl	ğŸ¸
monkey face	ğŸ‡§ğŸ‡¼
sight	ğŸ‡§ğŸ‡¼
deeper brown nose	ğŸ—
perfect	ğŸ‡½
electric light bulb	ğŸŸ
peace	ğŸŸ
boys	ğŸŸ
pa system	ğŸ‡¸ğŸ‡¾
sleepy	ğŸ‡¸ğŸ‡¾
greed	â†˜ï¸
alligator	ğŸœ
withdrawal	ğŸœ
powerboat	ğŸœ
halfpipe	ğŸœ
thumbs up	ğŸœ
thumb	ğŸœ
rocket	ğŸœ
farming	ğŸ˜
vespa	ğŸ”¸
pub	ğŸ¤™
fletching	ğŸ’„
light brown thumbs down sign	ğŸ’„
down arrow envelope	ğŸ’„
man in tuxedo	ğŸ“‡
satisfied	ğŸ“‡
cue	ğŸ“‡
hwatu	ğŸ“‡
ok	ğŸª
spike	ğŸ–Œ
hamster face	ğŸ’ƒğŸ¼
karaoke	â™ï¸
flag for poland	â™ï¸
wave	â™ï¸
shield	â™ï¸
without expression	â™ï¸
silhouettes	â™ï¸
black ear	â™ï¸
striped	â™ï¸
milky way	ğŸš¶ğŸ¾
flag for ethiopia	ğŸ‡³ğŸ‡·
olive toned face with no good gesture	ğŸ‡³ğŸ‡·
books	ğŸ‘Œ
folklore	ğŸ‘Œ
no	ğŸ‘Œ
confetti	ğŸ‘Œ
regional indicator symbol letters ge	ğŸ‘Œ
bball	ğŸ‘Œ
lower left paintbrush	ğŸ‘Œ
triangular flag on post	ğŸ‘Œ
dagger knife	ğŸ‘Œ
clinking beer mugs	ğŸ‘Œ
cute boy	ğŸ’‡ğŸ½
power	â†”ï¸
pawsteps	ğŸ¥ƒ
golf club	ğŸ¥ƒ
water feature	â†•ï¸
deeper brown man with turban	ğŸš‘
flag	ğŸš‘
white bicyclist	ğŸš‘
regional indicator symbol letters pt	ğŸš‘
eight spoked asterisk	ğŸš‘
aerial tramway	ğŸ™
information	ğŸ–±
organ	ğŸƒ
euro	ğŸƒ
house with garden	ğŸƒ
fall	ğŸƒ
jazz	ğŸƒ
regional indicator symbol letters ml	ğŸƒ
shamrock	ğŸƒ
martini glass	ğŸƒ
ticket	ğŸƒğŸ¿
cowgirl boots	â™‘
reverse arrows	â™‘
travel	â™‘
smoking	â™‘
regional indicator symbol letters sl	â™‘
chat bubble	â™‘
lovers	â™‘
sport	â†ªï¸
swirl	ğŸš€
calvary	ğŸš€
mahjong tile red dragon	ğŸš€
fish	ğŸš€
noodles with chopsticks	ğŸš€
drugs	ğŸš€
fried	ğŸš€
fish	ğŸ˜˜
pouting cat face	ğŸ˜˜
green	ğŸ˜˜
straight ruler	ğŸ˜˜
gambling	ğŸ˜˜
tanabata tree	ğŸ˜˜
playboy	ğŸ˜˜
musical	ğŸ˜˜
flag for tunisia	ğŸŒš
stop	ğŸŒš
cake	ğŸŒš
lion	ğŸŒš
lovestruck	ğŸŒš
flag for hong kong	ğŸŒš
regional indicator symbol letters no	ğŸŒš
bolt	ğŸŒš
honeydew	ğŸŒš
breath	ğŸŒš
silliness	ğŸŒš
beef	ğŸŒš
spacecraft	ğŸ”ƒ
nigiri	ğŸ—¾
world	ğŸ—¾
slow	ğŸ‘¤
transport	ğŸ‘¤
big grin	ğŸ‘¤
red cross	ğŸ‘¤
good	ğŸ‘¤
myopia	ğŸ‘¤
regional indicator symbol letters gt	ğŸ‘¤
musical note	ğŸ‘¤
keycap digit zero	ğŸ‘¤
flag for caribbean netherlands	ğŸ‘¤
flag for mexico	ğŸ‘¤
clutch	ğŸ‘¤
breakfast	ğŸ‘¤
love	ğŸ‘¤
steam	ğŸ
double curling loop	ğŸ
league	ğŸ
black club suit	ğŸ
wink face	ğŸ™‹ğŸ»
wedding bell	ğŸ½
granny	ğŸ½
airbus	ğŸ½
policeman	ğŸ½
school bus	ğŸ½
gay couple	ğŸ½
flavor	ğŸ½
scroll	ğŸ½
mouth	ğŸ½
sunrise	ğŸ½
deeper brown fisted hand sign	ğŸ½
road	ğŸ½
olive toned princess	ğŸ‡¹ğŸ‡©
cone	ğŸ‡¹ğŸ‡©
optical disc	ğŸ‘¿
selfie	ğŸ‘¿
crystal ball	ğŸ‘¿
morn	ğŸ‘¿
gesture	ğŸ‘¿
incoming envelope	ğŸ‘¿
salsa dancer	ğŸ‘¿
pain	â™
home	â™
flexing arm muscles	â™
regional indicator symbol letters ms	â™
pizza	â™
amaze	â™
melody	â™
night	â™
olive toned pedestrian	â™
white flexed biceps	ğŸ’•
4th	ğŸ’•
motel	ğŸ’•
castle	ğŸ’•
regional indicator symbol letters kp	ğŸ’•
deeper brown white down pointing backhand index	ğŸ’•
white haircut	ğŸ’•
flag for dominican republic	ğŸ’•
anger	ğŸŠ
twins	ğŸŠ
idaho	ğŸŠ
disappoint	ğŸŠ
hugs	ğŸŠ
regional indicator symbol letters cw	ğŸŠ
shortcake	ğŸŠ
finish	ğŸŠ
flag for malaysia	ğŸŠ
hearts	ğŸŠ
aries	ğŸ‘ğŸ¿
vulcan salute	ğŸ‡¸ğŸ‡»
anger	ğŸ‡¸ğŸ‡»
brown leaves	ğŸ‘®ğŸ¿
run	â˜¯
regional indicator symbol letters cy	ğŸ‘™
rail	ğŸ‘™
flag for greenland	ğŸ‘™
sparkling wine	âª
regional indicator symbol letters bh	ğŸ‘‚ğŸ½
drinkable	ğŸ›«
closed lock with key	ğŸŒŠ
massage	ğŸŒŠ
video camera	ğŸŒŠ
black flexed biceps	ğŸŒŠ
hammer	ğŸŒŠ
dormouse	ğŸŒŠ
joker	ğŸŒŠ
loudly crying face	ğŸŒŠ
astrology	ğŸŒŠ
bottle	ğŸ‡
cancer	ğŸ‡
smiley face	ğŸ‡
cat paw prints	ğŸ‡
objective	ğŸ‡
silly	ğŸ‡
flag for oman	ğŸ‡
knife	ğŸ–
mask	ğŸ‡¨ğŸ‡º
sprout	ğŸ‡¨ğŸ‡º
fearful face	ğŸ‡«ğŸ‡°
car bonnet	ğŸ‡«ğŸ‡°
flag for somalia	ğŸ–²
flag for latvia	ğŸ‡³ğŸ‡±
tap dance	ğŸ‡³ğŸ‡±
clippy	ğŸ‡³ğŸ‡±
night	ğŸ‡¦ğŸ‡®
grumpy cat	ğŸ‡¦ğŸ‡®
sound	ğŸ‡¹ğŸ‡´
friendly	ğŸ‡¹ğŸ‡´
money	ğŸ‡²ğŸ‡³
planet	ğŸ‡²ğŸ‡³
two pink hearts	ğŸ‡²ğŸ‡³
regional indicator symbol letters sn	ğŸ‘´ğŸ»
playstation	ğŸš£ğŸ¾
smiling	â˜ºï¸
bag	â˜ºï¸
inebriated	â˜ºï¸
umbrella on ground	â˜ºï¸
blown	â˜ºï¸
cool	ğŸ‘ŠğŸ¼
face with hat	â°
flag for burundi	â°
name badge	â°
white right pointing backhand index	ğŸ‘†ğŸ»
death	â‡ï¸
side of car	ğŸ›
parents with child	ğŸº
smiling	ğŸº
religious building	ğŸº
dwelling	ğŸº
fishcake	ğŸº
tennis	ğŸº
helmet with white cross	ğŸ¤µ
memo	ğŸ¤µ
spring	ğŸ¤µ
dance	ğŸ•”
pranava	ğŸ—£
house and tree	ğŸ“
speech bubble	ğŸ“
barber shop	ğŸ“
obento	ğŸ“˜
regional indicator symbol letters gd	ğŸ¨
penis	ğŸ¨
transportation	ğŸ¨
spirits	ğŸ¨
french fries	ğŸ‡»ğŸ‡¬
athletic shoe	ğŸ‡»ğŸ‡¬
sign	ğŸ‡»ğŸ‡¬
pole	ğŸ“´
insect	â¬œï¸
pucker	ğŸš
eye	ğŸš
hourglass	ğŸš
face screaming in fear	ğŸš
regional indicator symbol letters mo	ğŸš
loving couple	ğŸš
star and crescent	ğŸš
ear	ğŸš
cheese	ğŸ”§
bellhop bell	ğŸ”§
unimpressed	ğŸŒ
north east arrow	ğŸŒ
moon	ğŸŒ
hearing	ğŸŒ
crime	ğŸŒ
china	ğŸŒ
dressed	ğŸŒ
laughing	ğŸŒ
nauseated face	ğŸ™…ğŸ¿
ano niku	ğŸ³
horse racing	âš¾ï¸
automobile	ğŸ˜Š
regional indicator symbol letter x	ğŸ˜Š
squared ng	ğŸ˜Š
page facing up	ğŸ˜Š
bird	ğŸ˜Š
smiling	ğŸ˜Š
hat	ğŸ—ƒ
sunny	ğŸ‘¹
regional indicator symbol letter i	ğŸ‘¹
swim	ğŸ‘¹
regional indicator symbol letters sg	ğŸ‘¹
kiss	ğŸ‘¹
frown	ğŸ‘¹
soak	ğŸ‘¹
phase	ğŸ‘¹
coconuts	ğŸ‘¹
rollercoaster	ğŸ‘¹
squared sos	ğŸ‘¹
microphone	ğŸ‘¹
go	ğŸ‘¹
capsule	ğŸ‘¹
grow	ğŸ‘¹
transport	ğŸ‘¹
bearskin	ğŸ—¼
blonde	ğŸ—¼
nope	ğŸ—¼
flag for cocos islands	ğŸ˜¥
steam	ğŸ˜¥
housecat	ğŸ˜¥
turkey leg	ğŸ˜¥
top	ğŸ«
unhappy	ğŸ«
hair flick	ğŸ«
ball	ğŸ«
flag for thailand	ğŸ«
breaststroke	ğŸ«
disco dancer	ğŸ«
red crab	ğŸ«
racquet	ğŸ«
hive	â˜„
flag for madagascar	â˜„
hump day	â˜„
fermented	ğŸ‡¹ğŸ‡»
money face	ğŸ‡¹ğŸ‡»
pineapple	ğŸ”¢
japanese symbol for beginner	ğŸ”¢
dito medio	ğŸ”¢
person on bike	ğŸ”¢
face	ğŸ’´
guest	ğŸ’´
cricket bat and ball	ğŸ’´
cow	ğŸ’´
whistling	ğŸ’´
space invader	ğŸ’´
backhand	ğŸ’´
mizaru	ğŸ’´
flag for iran	ğŸ’´
regional indicator symbol letters tz	ğŸ’´
litter	ğŸ’´
rainbow	âœ‹
flush	âœ‹
transport	âœ‹
deeper brown raised hand with part between middle and ring fingers	ğŸ‘†ğŸ¾
thought balloon	â˜ª
juicy	Â®ï¸
zodiac	â›³ï¸
orange	ğŸš®
birth	ğŸš®
cat	ğŸš®
information source	ğŸš®
regional indicator symbol letters ag	ğŸš®
queen	ğŸš®
crÃ¨me	ğŸš®
domed roof	ğŸš®
ears	ğŸš®
oncoming automobile	ğŸ’ˆ
domestic cat	ğŸ’ˆ
regional indicator symbol letters fj	ğŸ’ˆ
musical	ğŸ’ˆ
rightwards arrow with hook	ğŸ¦€
tongue out	ğŸ¦€
dice	ğŸ¦€
game die	â–ªï¸
smiley face	ğŸ‘¦ğŸ½
gator	ğŸ®
juggling	ğŸ®
sign	ğŸ®
football	ğŸ‡²ğŸ‡½
on	ğŸ‡²ğŸ‡½
detective	ğŸ‡²ğŸ‡½
regional indicator symbol letters ht	ğŸƒ
keycap digit one	ğŸƒ
symbol input	ğŸƒ
letter	ğŸƒ
clock face seven oclock	ğŸƒ
white down pointing backhand index	ğŸƒ
seedling	ğŸƒ
pudding	ğŸƒ
travel	ğŸ¯
firework sparkler	ğŸ¯
picture	ğŸ¯
automobile	ğŸ¯
car	ğŸ¯
clapper	ğŸ¯
white man with gua pi mao	ğŸ¯
alarm	ğŸ¯
ouch	ğŸ¯
baseball	ğŸ¯
old house	ğŸ†š
leaf	ğŸ¹
frosty the snowman	ğŸ¹
sun with face	ğŸˆº
black circle for record	ğŸˆº
respect	ğŸ˜›
officer	ğŸ˜›
australia	ğŸ˜›
gala apple	ğŸ˜›
love heart	ğŸ˜›
period piece	âŒ›
treble clef	ğŸ¹
sashimi	ğŸ¹
jeans	â“‚ï¸
deeper brown person frowning	ğŸ‡§ğŸ‡®
stew	ğŸ‡§ğŸ‡®
team	ğŸ‘±ğŸ¾
shocked	ğŸ‰‘
pink bow	ğŸ˜²
white person frowning	ğŸ˜²
team	ğŸ˜²
computer	ğŸ˜²
guadeloupean flag	ğŸ˜²
crazy face	ğŸ˜²
video game monster	ğŸ˜²
motorbike	ğŸ–
winery	ğŸ–
puppy	ğŸ–
hot	ğŸ–
trot	ğŸ–
rosette	ğŸ–
short	ğŸ–
heart eyes	ğŸ–
crime	ğŸ–
work	ğŸ–
dark heart	ğŸ–
heart	ğŸ–
clean	ğŸ‘ˆ
bamboo	ğŸ‘ˆ
abcd	â¬…ï¸
kissing	ğŸ—’
squared vs	ğŸ‡±
bullant	âš”
clear	â˜ 
gridiron	âœ‰ï¸
stop	ğŸ––ğŸ¾
pager	ğŸ‹
bandaged head	ğŸ‹
regional indicator symbol letters pl	ğŸ‹
stay	ğŸ‹
train station	ğŸ‹
regional indicator symbol letters ki	ğŸ‹
adorable	ğŸ‹
aumkara	ğŸ‹
heart eyes cat	ğŸ˜œ
content	ğŸ˜œ
bell	ğŸ˜œ
maize	ğŸ˜œ
checkered flag	ğŸ˜œ
asian lantern	ğŸ˜œ
luck	ğŸ˜œ
zodiac	ğŸ˜œ
japanese	ğŸš
ledger	âœ‹ğŸ¿
arts	ğŸ”‚
flag for pakistan	ğŸ”‚
kermit	ğŸ”‚
christmas island flag	ğŸ‡®ğŸ‡³
splashing sweat symbol	ğŸ‡®ğŸ‡³
railway track	ğŸ‡®ğŸ‡³
olive toned information desk person	ğŸ§
regional indicator symbol letters co	ğŸ§
nauruan flag	ğŸ§
wheelchair symbol	ğŸ§
car	ğŸ§
hush	ğŸ§
husk	ğŸ§
white smiling face	ğŸ§
public address loudspeaker	ğŸ‡±ğŸ‡¨
railcar	5ï¸âƒ£
regional indicator symbol letters cv	ğŸ—‘
awkward	ğŸ””
love note	ğŸ””
bag	ğŸ””
no phones	ğŸ””
roller	ğŸŒ­
necktie	ğŸŒ­
taco	ğŸŒ­
hat	ğŸ‡¸ğŸ‡·
nerd face	ğŸ‡¸ğŸ‡·
doughnut	ğŸº
face with rolling eyes	ğŸº
meat	ğŸº
camcorder	ğŸº
convenient	ğŸº
tree	ğŸº
regional indicator symbol letters mq	ğŸº
yeast	ğŸº
screaming face	ğŸº
faroe islander flag	ğŸº
fragrant	ğŸº
stride	ğŸº
purple devil	ğŸº
sedan	ğŸº
fall	ğŸº
bowl	ğŸš’
face massage	ğŸš’
flag for syria	ğŸš’
motorboat	ğŸš’
swirl	ğŸš’
sport stadium	ğŸš’
sailboat	ğŸš’
back with leftwards arrow above	ğŸš’
cake with candles	ğŸš’
smiling sun	ğŸš
trade mark sign	ğŸš
playing card black joker	ğŸš
earth	ğŸš
grin	ğŸš
ok	ğŸš
white rowboat	ğŸš
pagri	ğŸš
sweat	ğŸš
astrology	ğŸ’™
sausage	ğŸ’™
flag for nepal	ğŸ’™
umbrella	ğŸ’™
flag for vatican city	ğŸ’™
police	ğŸ’™
cutting	ğŸ’™
mobile phone off	ğŸ’™
rude finger	ğŸ‘
green leaves	ğŸ‘
mobile phone with rightwards arrow at left	ğŸ‘
flag for uruguay	ğŸ‘
eyeglasses	ğŸ‘
hole	ğŸ‘
water closet	ğŸ‘
city	ğŸ‘
frames	ğŸ‘
cherries	ğŸ‘
purple	ğŸ‘
comic	ğŸ‘
monsters	ğŸ‘¨
chocolate	ğŸ‘¨
flag for panama	ğŸ‘¨
greek	ğŸš‡
innocent	ğŸš‡
regional indicator symbol letters de	ğŸš‡
fountain	ğŸš‡
syrup	ğŸ‹
two women holding hands	ğŸ‹
official	ğŸ‹
ear	ğŸ‹
deeper brown baby	ğŸ‹
shopping	ğŸ›
regional indicator symbol letters cf	ğŸ›
olive toned nail polish	ğŸ›
nonplussed	ğŸ›
performance	ğŸ›
lacking	ğŸ›
listening	ğŸ˜‘
construction sign	ğŸ˜‘
golf	ğŸ˜‘
kiss mark	ğŸ˜‘
scrunched face	ğŸ˜‘
festival	ğŸ˜‘
regional indicator symbol letters id	ğŸ˜‘
petrol pump	ğŸ˜‘
love	ğŸ¾
tetraodontidae	ğŸ¾
purple vegetable	ğŸ¾
spirits	ğŸ¾
singlet	ğŸ¾
transportation	ğŸ¾
snow	ğŸ¾
satellite antenna	ğŸ¾
wine	ğŸ¾
constellation	ğŸ¾
high heels	ğŸ¾
flag for isle of man	ğŸ¾
railway	ğŸ™
european	ğŸ™
woman	ğŸ™
railway carriage	ğŸ™
full moon with face	ğŸ™
fast forward	ğŸ™
horns	ğŸ™
regional indicator symbol letters mx	â—
possessive	ğŸ‡¨ğŸ‡¾
foreign	ğŸ‡¨ğŸ‡¾
regional indicator symbol letters gw	ğŸ‡³ğŸ‡µ
purchase	ğŸ‡³ğŸ‡µ
handyman	ğŸ›€ğŸ»
spiral calendar pad	ğŸ‡­ğŸ‡¹
thermometer	ğŸ‡­ğŸ‡¹
mute volume	ğŸ‡­ğŸ‡¹
top	ğŸ™†ğŸ¾
regular potato	ğŸ’¾
bow and arrow	ğŸ’¾
currency	ğŸ’¾
lion	ğŸ’¾
fast	ğŸ’¾
sad	ğŸ’¾
fishing pole and fish	ğŸ’¾
sexy	ğŸ’¾
nearsightedness	ğŸ˜†
listen	ğŸ˜†
birthday cake	ğŸ˜†
utensil	ğŸ˜†
honey	ğŸ§
sagittarius	ğŸ§
floppy disk	ğŸ§
kitten	ğŸ§
electric	ğŸ§
jaw	ğŸ§
intense	ğŸ§
flag for kenya	ğŸ§
alcohol	ğŸ
straight couple	ğŸ
aeroplane	ğŸ
veil	ğŸ
delivery	ğŸ‡§ğŸ‡¿
rich	ğŸ‡§ğŸ‡¿
new york taxi	ğŸ…ğŸ¼
bubble	â™Š
zodiac	â™Š
meow	â™Š
education	â™Š
light bulb	â™Š
greek	â™Š
label	â™Š
distressed	â™Š
meteoroid	ğŸ‡¬ğŸ‡©
stars	ğŸ‡¬ğŸ‡©
pants	ğŸ‘½
clockwise rightwards and leftwards open circle arrows	ğŸ‘½
constellation	ğŸ‘½
png flag	ğŸ‘½
bowl of food	ğŸ“‘
greek	ğŸ—œ
ropeway	ğŸ‡»
last	â„ï¸
rail	â„ï¸
bills	â„ï¸
pit	â„ï¸
celebrate	â„ï¸
swish	â„ï¸
exhausted	â„ï¸
sky	â„ï¸
olive toned woman	â„ï¸
black telephone	â„ï¸
blue book	â„ï¸
squared up with exclamation mark	â„ï¸
amusement	â„ï¸
prints	â„ï¸
regional indicator symbol letters om	ğŸ–Š
kissy face	ğŸ¢
lord	ğŸ¢
yellow heart	ğŸ‡©ğŸ‡¬
breasts	ğŸ™ğŸ¾
sorry	ğŸ‡
safety helmet	ğŸ‡
appetizer	ğŸ‡
potato	ğŸ‡
regional indicator symbol letters mt	ğŸ‡
south west arrow	ğŸ‡
grin	ğŸ‡
joke	ğŸ‡¨ğŸ‡±
laughing tears	ğŸ‡¨ğŸ‡±
mad	ğŸ’¢
confetti ball	ğŸ’¢
notifications enabled	ğŸ’¢
stack of books	ğŸ’¢
sensitive	â›
train	â›
boeing	â›
ballet	â›
derelict house building	â›
milk	â›
regional indicator symbol letters mm	â›
explode	â›
deeper brown raised hand	ğŸ†“
phase	ğŸ†“
tool	ğŸ•´
factory	ğŸ•´
spooky	ğŸ•´
backpack	ğŸ¥•
hospital	ğŸ
present	ğŸ
sky	ğŸ
bajan flag	ğŸ
subway	ğŸ
cd	ğŸ
stop	ğŸ¤œ
flag for cambodia	ğŸ‘‡ğŸ¿
mochi	ğŸ“”
ten pin bowling	ğŸ‘®
city	ğŸ‘®
koala bear	ğŸ‘®
royalty	ğŸ‘®
olive toned bath	ğŸ‘®
fried	ğŸ¡
olive toned man	ğŸ¡
girls holding hands	ğŸ¡
home	ğŸ¡
flag for portugal	ğŸ¡
pregnant woman	ğŸ¡
black question mark ornament	ğŸ¡
announcement	ğŸ¡
livid	ğŸ¡
africa	ğŸš´ğŸ»
chequered flag	ğŸ‡²ğŸ‡º
mountain	ğŸ‡±ğŸ‡§
rage	ğŸ‡±ğŸ‡§
saint nick	ğŸ´
flag for tuvalu	ğŸ´
speaker with cancellation stroke	ğŸ‡¶
tub	ğŸ‘µğŸ¾
no entry	ğŸ–‡
ladybug	9âƒ£ï¸
red lantern	ğŸ‘¸ğŸ¼
circled ideograph secret	ğŸ‘‚
entertainment	ğŸ‘‚
vision	ğŸ‘‚
flag for mauritius	ğŸ‘‚
amex	ğŸ‘©ğŸ¾
page with curl	ğŸ‘¼ğŸ¼
moon	â›”
cat	ğŸ’…ğŸ¾
bride with veil	ğŸ”
drought	â„¢ï¸
grinning face	ğŸ•›
sheep	ğŸ‡ªğŸ‡¨
fruit	ğŸ‡ªğŸ‡¨
beeper	ğŸ‡ªğŸ‡¨
no deal	ğŸ™ğŸ»
meat	ğŸ“
seat	ğŸ“
nut and bolt	ğŸ“
power cable	ğŸ’Œ
cop car	ğŸ’Œ
somber	ğŸ’Œ
chain	ğŸ’Œ
lost	ğŸ’Œ
poke	ğŸ’Œ
beach with umbrella	ğŸ’Œ
manicure	ğŸ’‚ğŸ¾
warning sign	ğŸ‡§ğŸ‡´
coffee	ğŸ‡§ğŸ‡´
summer	ğŸ‡§ğŸ‡´
alien monster	ğŸ‘ğŸ»
eat	ğŸ‘°ğŸ¼
marriage	ğŸ–¼
japanese	ğŸ–¼
flipping the bird	ğŸ–¼
couple in love	ğŸ–¼
unicorn	ğŸˆ¶
application form	ğŸˆ¶
regional indicator symbol letters ci	ğŸ˜—
plant	ğŸ˜—
magician	ğŸ˜—
flag for bahrain	ğŸ˜—
bridge	ğŸ˜—
lips	ğŸ˜—
flag for mali	ğŸ˜—
grief	ğŸ˜—
wash	ğŸ˜—
frown	ğŸ¶
passenger ship	ğŸ¶
playful	ğŸ¶
crooked	ğŸ¶
pedal	ğŸ¶
moon	ğŸ¶
smiley	ğŸ¶
flag for marshall islands	ğŸ¶
union jack	ğŸ¶
dog	ğŸ¶
black fisted hand sign	â›´
stars	ğŸ‡§ğŸ‡ª
rowboat	ğŸ‡§ğŸ‡ª
pipe	ğŸ‘¢
playful	ğŸ‘¢
popper	ğŸ‘¢
newspaper	ğŸ‘¬
cold	ğŸ‘¬
drink	ğŸ‘¬
truck	ğŸ‘¬
bottle	ğŸ‘¬
friends	ğŸ‘¬
slightly smiling face	ğŸ‘¬
royal	ğŸ‘¬
hot pepper	ğŸ‘¬
bar	ğŸ‘¬
empty and available	ğŸ‘¬
love hotel	ğŸ‘¬
pine	ğŸ”˜
passion	ğŸšº
mother	ğŸšº
rebirth	ğŸšº
alcohol	ğŸšº
heart	ğŸšº
shipyard	ğŸšº
rice	ğŸšº
skullcap	ğŸšº
teacher	ğŸšº
smug	ğŸšº
waning gibbous moon symbol	â›ª
mountain	â›ª
russet	â›ª
open mailbox	ğŸ˜®
denim	ğŸ˜®
women	ğŸ˜®
scene	ğŸ˜®
hitch hike	ğŸ˜®
flag for martinique	ğŸ˜®
small airplane	ğŸ‡ªğŸ‡·
glass	ğŸ‡ªğŸ‡·
night	ğŸ‘ğŸ»
table tennis	ğŸ’‚
spiral	ğŸ’‚
flame	ğŸ’‚
light brown older woman	ğŸ’‚
olive toned happy person raising one hand	ğŸ’‚
onsen	ğŸ’‚
lesbian	ğŸ’‚
police siren	ğŸ’‚
ballot box with check	ğŸ’‚
south east arrow	ğŸ’‚
cluster	ğŸ‘¨â€ğŸ‘¨â€ğŸ‘§
shirt and tie	ğŸ“¸
raised hand	ğŸ˜ƒ
lather	ğŸ˜ƒ
understanding	ğŸ˜ƒ
ticket stub	ğŸ˜ƒ
gas	ğŸ˜ƒ
sun behind cloud	ğŸ˜ƒ
grade	ğŸ˜ƒ
squared katakana sa	ğŸ˜ƒ
sleepy face	ğŸ„ğŸ½
binder	ğŸ‡¬ğŸ‡¼
queen	ğŸ’±
chart with upwards trend	ğŸ‡
rÃ©unionnais flag	ğŸ§
sick	ğŸ§
price tag	ğŸ§
queen	ğŸ§
cap	ğŸ§
light brown baby angel	ğŸ§
flag for lithuania	ğŸ§
light brown white up pointing backhand index	ğŸ§
hug	ğŸ§
naruto	ğŸ§
beach	ğŸ‘ˆğŸ¿
moneybags	ğŸ•Š
abcd	ğŸ‡¹ğŸ‡±
exhausted	ğŸ‡¸ğŸ‡³
pained face	ğŸ‡¸ğŸ‡³
amusement	ğŸŠğŸ¾
astrology	ğŸ«
sad	ğŸ«
beninese flag	ğŸ«
hot weather	ğŸ«
night	ğŸ«
middle finger	ğŸ«
flag for antarctica	ğŸ›‹
moustache man	ğŸ›‹
instrument	ğŸ›‹
closed book	ğŸ”ª
cash	ğŸ”ª
thick	ğŸ”ª
red tower	ğŸ”ª
blurry	ğŸ
pig nose	ğŸ‡ºğŸ‡¿
pout	ğŸ‡ºğŸ‡¿
user	ğŸ‡¯ğŸ‡´
regional indicator symbol letters tl	ğŸ‡¯ğŸ‡´
dressing	ğŸ‡µğŸ‡¬
bumble	ğŸ‡µğŸ‡¬
dead flower	ğŸ‡µğŸ‡¬
military	ğŸ‡µğŸ‡¬
white guardsman	ğŸš«
gas	ğŸš«
smell	ğŸš«
face throwing a kiss	ğŸš«
input symbol for symbols	ğŸš«
aquarius	ğŸš«
black waving hand sign	ğŸš«
family	ğŸš–
draw	ğŸš–
regional indicator symbol letters gm	ğŸš–
eye in speech bubble	ğŸš–
motor bike	ğŸš–
clink	ğŸš–
billy goat	ğŸš–
ram	ğŸš–
tropical	ğŸš–
grey skull	ğŸ’
mice	ğŸ’
october	ğŸ’
family of a man and woman with two boys	ğŸ’
feet	ğŸ¦‡
america	ğŸ¦‡
clock face twelve oclock	ğŸ¦‡
singing	ğŸ–
education	ğŸ–
grumpy face	ğŸ–
pick	ğŸ–
fire	ğŸ–
clock face one oclock	ğŸ–
mortarboard	ğŸ–
loop once symbol	ğŸ–
leaf	ğŸ–
glowing	ğŸ‡«ğŸ‡´
horn	ğŸ‡«ğŸ‡´
fire	ğŸ‡«ğŸ‡´
420	ğŸ‡¼ğŸ‡¸
dart	ğŸ‡¼ğŸ‡¸
exercise	ğŸ‡¨ğŸ‡°
street	ğŸ‡¨ğŸ‡°
regional indicator symbol letters re	ğŸ‚
toilet wc	ğŸ‚
wedding	ğŸ‚
luck	ğŸ‚
old man	ğŸ‚
regional indicator symbol letters ua	ğŸ‚
lager	ğŸ‚
regional indicator symbol letters il	ğŸ‚
keycap digit eight	ğŸ‚
artist palette	ğŸ‚
deciduous	ğŸ‚
stars	ğŸ‚
ewe	ğŸ‡°ğŸ‡¿
perplex	ğŸ‡°ğŸ‡¿
bass guitar	ğŸ™ŒğŸ¾
disappointed but relieved face	ğŸ¿
gibbous	ğŸ¿
briefcase	ğŸ“½
yin yang	ğŸš‹
cityscape	ğŸš‹
constellation	ğŸš‹
chequred	ğŸš‹
restroom	â˜•ï¸
tear	ğŸ‘³ğŸ½
protection	ğŸ‡¯ğŸ‡ª
distress signal	ğŸ™…ğŸ¾
battery	ğŸ‘±
pool	ğŸ‘±
craps	ğŸ‘±
black bath	ğŸ‘±
clapper board	ğŸ‘±
saint	ğŸ‘±
happy face	ğŸ‘±
accessory	ğŸ‘±
postbox	ğŸŒ•
new caledonian flag	ğŸŒ•
satchel	ğŸŒ•
discouraged	ğŸŒ•
open	ğŸŒ•
cold	ğŸŒ•
gondola	ğŸŒ•
tall	ğŸŒ•
child	ğŸŒ•
not drinkable	ğŸŒ•
wheel of dharma	ğŸŒ•
regional indicator symbol letters mp	ğŸŒ¦
rodent	ğŸ‡¨ğŸ‡¦
clover	ğŸ‡¨ğŸ‡¦
male restroom	ğŸ“‚
sweat	ğŸ“‚
banana	ğŸ‘ğŸ¼
bird	ğŸ¢
umbrella	ğŸ¢
aquarius	ğŸ¢
pollination	ğŸ¢
bolivian flag	ğŸ¢
destination	ğŸ¢
flower	â¬›
tree	ğŸ™‹ğŸ¾
shinkansen	â™
first	â™
go	â™
coca	â™
flagstick	â™
city at night	â™
microscope	â™
christmas tree	â™
smile	ğŸ‡¹ğŸ‡¬
saints	ğŸ‡¹ğŸ‡¬
circle	ğŸ“
park	ğŸ“
wilted flower	ğŸ“
compression	ğŸ“
poles	ğŸ‹
love	ğŸ‹
flag for south sudan	ğŸ’¬
barbecue	ğŸ’¬
happiness	ğŸ’¬
file cabinet	ğŸ’¬
hops	ğŸ’¬
h20	ğŸ’¬
portland	ğŸ’¬
gabonese flag	ğŸ’¬
net	ğŸ’¬
pout	ğŸ’¬
colt	ğŸ‘¸ğŸ½
small blue diamond	ğŸ‘‘
gift	ğŸ‘‘
regional indicator symbol letters mn	ğŸ‘‘
moyai statue	ğŸ‘‘
sparkling heart	â›‘
bird flu	ğŸ’ƒ
winking	ğŸ’ƒ
hungry	ğŸ’ƒ
bow	ğŸ’ƒ
approval	ğŸ’ƒ
caterpillar	ğŸ’ƒ
ç©º	ğŸ’ƒ
conceited	ğŸ’ƒ
sign	ğŸ’ƒ
glasses	ğŸ’ƒ
tasty	ğŸ’ƒ
shared	ğŸ’ƒ
curtsy	ğŸ’ƒ
desert	ğŸ’ƒ
magic 8 ball	ğŸ’…ğŸ»
skewer	ğŸ¥€
car	ğŸ¥€
taurus	ğŸ¥€
surf	ğŸ‘”
planet	ğŸ‘”
white heavy check mark	ğŸ‘”
pinocchio	ğŸ‘”
cheese	ğŸ’
dusk	ğŸ’
quiz	ğŸ’
yellow	ğŸ’
snarky	ğŸ’
brass	ğŸ’
gold star	ğŸ’
keycap digit six	ğŸ’
bike pedal	ğŸ’
crying	ğŸ
reward	ğŸ†‘
game	ğŸ†‘
zodiac	ğŸ†‘
flower	ğŸ¥“
quarter	ğŸ˜¢
regional indicator symbol letters ir	ğŸ˜¢
story	ğŸ˜¢
black boy	ğŸ˜¢
desk calendar	ğŸ˜¢
yellow flower	ğŸ˜¢
fed up	ğŸ‡®ğŸ‡¶
ocean	ğŸ‡®ğŸ‡¶
manga meat	ğŸ‡®ğŸ‡¶
soccer ball	ğŸš„
toilet	ğŸš„
tired	ğŸš„
raised hand with fingers splayed	ğŸ‡º
ferry	ğŸ’ğŸ¼
dairy	ğŸ¤ 
black happy person raising one hand	ğŸ¤ 
indian flag	ğŸ›€ğŸ¿
smiling cat	ğŸ‡¦ğŸ‡¿
train	ğŸ‡¦ğŸ‡¿
snapchat mutual best friends	ğŸ‡¦ğŸ‡¿
plant	ğŸ‘©â€ğŸ‘©â€ğŸ‘§
greek	ğŸŒµ
regional indicator symbol letters rw	ğŸŒµ
mouse with whiskers	ğŸŒµ
black diamond suit	ğŸŒµ
negative squared latin capital letter a	ğŸŒµ
owl	ğŸŒµ
heavy heart exclamation mark ornament	âœ–ï¸
voice	ğŸ”®
hump	ğŸ”®
british indian ocean territory flag	ğŸ”®
imac	ğŸ”®
chicken	ğŸ”®
control knobs	ğŸ”®
medal	ğŸ”®
zodiac	â›¸
selfless	ğŸŸ
slots	ğŸŸ
keycap asterisk	ğŸŸ
sleeping symbol	ğŸŸ
pout	ğŸŸ
japanese	ğŸŸ
shopping bags	ğŸŸ
hockey	ğŸŸ
white raised hand	ğŸ‘†ğŸ¼
phase	ğŸ’‡ğŸ¼
ringer	ğŸŒ
deeper brown man	ğŸŒ
smiling face with open mouth and smiling eyes	ğŸŒ
department	ğŸŒ
regional indicator symbol letters nu	ğŸŒ
flag for finland	ğŸŒ
tigger	ğŸŒ
santa	ğŸŒ
no	ğŸŒ
regional indicator symbol letters cu	ğŸ‡§ğŸ‡¸
irritated	ğŸ‡§ğŸ‡¸
fox	ğŸ“¢
h building	ğŸ“¢
disk	ğŸ“¢
card	ğŸ‡ğŸ½
atom symbol	ğŸ‘©ğŸ¼
sadface	ğŸ‡®ğŸ‡©
greek	ğŸ‡®ğŸ‡©
olive toned thumbs up sign	ğŸ‘ˆğŸ¾
coffin	ğŸŠğŸ»
medical	ğŸ”¼
skeleton	ğŸ¤
citation	ğŸ¤
racing car	ğŸ”Œ
ballerina	ğŸ”Œ
ballet	ğŸ”Œ
triple crown	ğŸ”Œ
cancer	ğŸ•
scream	ğŸ•
americas	ğŸ•
flag for palestinian territories	ğŸ•
flag for gibraltar	ğŸ•
draft	ğŸ’†ğŸ¼
regional indicator symbol letters lu	ğŸ‡»ğŸ‡º
old lady	ğŸ‡»ğŸ‡º
creepy moon	ğŸ‡ªğŸ‡¬
fearful	ğŸ‡ªğŸ‡¬
flower	ğŸ‡ªğŸ‡¬
yellow	ğŸš´ğŸ¾
smile	ğŸ‘¾
hotel	ğŸ‘¾
train and mountain	ğŸ‘¾
glass	ğŸ‘£
hallelujah	ğŸ‘£
greek	ğŸ‘£
flag for guam	ğŸ‡¦ğŸ‡º
chadian flag	ğŸ‡¦ğŸ‡º
amphora	ğŸ‡¦ğŸ‡º
rooster	ğŸ‡¦ğŸ‡º
circled latin capital letter m	ğŸ‘ğŸ¾
hobs	ğŸ—¿
weary cat face	ğŸ—¿
church wedding	ğŸ—¿
stars	ğŸ—¿
bathroom	ğŸ—¿
open hands sign	ğŸ‡°ğŸ‡µ
face with straight mouth	ğŸ‡°ğŸ‡µ
anger symbol	ğŸ’½
bees	âœ´ï¸
easter	âœ´ï¸
entertainment	ğŸš¶
dizzy symbol	ğŸš¶
flag for israel	ğŸš¶
sparkles	ğŸš¶
vinegar	ğŸš¶
link symbol	ğŸš¶
decrease brightness	ğŸš¶
food	ğŸš¶
fishing	ğŸŒ°
cash	ğŸŒ°
heart alarm	ğŸŒ°
rice	ğŸŒ°
gift box	ğŸŒ°
fish	ğŸŒ°
soft	ğŸ˜º
laughing crying	ğŸ˜º
pointing to phone	ğŸ˜º
harbor	ğŸ˜º
flag for zimbabwe	ğŸ˜º
seafood	ğŸ˜º
no water	ğŸ˜º
weightlifting	ğŸ‡¨ğŸ‡µ
womens symbol	ğŸƒğŸ»
golf	ğŸ“
face with thermometer	ğŸ“
white person with folded hands	ğŸ“
flag for equatorial guinea	ğŸ“
clumsy	ğŸ“
flag for kiribati	ğŸ“
money	ğŸ“
praying hands	ğŸ“
white raised hand with part between middle and ring fingers	ğŸ“
night	âš’
cruise ship	ğŸ±
crop	ğŸ±
mandarin	ğŸ±
white ok hand sign	ğŸ…ğŸ»
loaf	ğŸ‚
bumble bee	ğŸ‚
boar	ğŸ‚
barbers stripes	ğŸ‚
clubs	ğŸ‚
baby bottle	ğŸ‚
assignment	ğŸ‚
purse	ğŸ‚
trust	ğŸ‘ƒğŸ¾
silly	â˜˜
bus	ğŸ‘‰ğŸ¿
cheese	â™Œï¸
regional indicator symbol letters sv	â™Œï¸
baby	â™Œï¸
transportation	â™Œï¸
flag for comoros	â™Œï¸
campervan	â™Œï¸
bear face	â™Œï¸
temperature	â™Œï¸
world	ğŸ«
file folder	ğŸ«
popcorn	ğŸ«
black dancer	ğŸ«
dog paw prints	ğŸ«
flag for turkmenistan	ğŸ«
bicycle	ğŸ«
travel	ğŸ«
italian	ğŸ«
tree	ğŸ«
bath	ğŸ«
trolleybus	ğŸ«
id	ğŸ‡·ğŸ‡ª
dolphin	ğŸ‡·ğŸ‡ª
black person with folded hands	ğŸ‡·ğŸ‡ª
stars	ğŸ™‹
skull	ğŸ™‹
gapping	ğŸ™‹
spotted	ğŸ™‹
japanese ogre	ğŸ™‹
hear	ğŸ™‹
regional indicator symbol letters et	ğŸ™‹
regional indicator symbol letters pk	ğŸ™‹
running	ğŸ‘ˆğŸ»
earth	ğŸ‘­
android	ğŸ‘­
white raised fist	ğŸ‘­
winter	ğŸ‘­
do not litter symbol	ğŸ‘­
united states	ğŸ‘­
white large square	ğŸ‘­
cap	ğŸ‘­
last quarter moon symbol	ğŸ‘­
colors	ğŸ‘­
hand	ğŸ‘­
cucumber	ğŸ‘­
pregnancy	ğŸ‘­
moon	ğŸ‘­
white flower	ğŸ‘­
trolley bus	âš›
tree	ğŸ˜«
austrian flag	ğŸ˜«
elephant	ğŸ˜«
socially awkward penguin	ğŸ˜«
exhausted	ğŸ˜«
children	ğŸ‡°ğŸ‡²
increase volume	ğŸ‡°ğŸ‡²
sunset	ğŸ˜‚
devil	ğŸ˜‚
tree	ğŸ˜‚
meditate	ğŸ˜‚
regional indicator symbol letters at	ğŸ˜‚
furin	ğŸ˜‚
flag for macedonia	ğŸ˜‚
pufferfish	ğŸ˜‚
graduation	ğŸ˜‚
wash	ğŸ„ğŸ¼
rise	ğŸ¢
color	ğŸ¢
light brown haircut	ğŸ¢
mountain bicyclist	ğŸ¢
male	ğŸ¢
regional indicator symbol letters ph	ğŸ¢
zodiac	ğŸ¢
grimace	ğŸ¢
water drops	ğŸ¢
miffed	ğŸ¢
please	ğŸ”
wolf face	ğŸ”
playing cards	6ï¸âƒ£
stars	ğŸ™…ğŸ»
flag for ireland	ğŸˆ³
train	ğŸˆ³
pushpin	ğŸ˜”
red apple	ğŸ˜”
tropical fish	ğŸ˜”
sale	ğŸ˜”
regional indicator symbol letters ni	ğŸ˜”
praise	ğŸ˜”
british flag	ğŸ˜”
film camera	ğŸ˜”
water	ğŸ˜”
drink	ğŸ˜”
minaret	ğŸ˜”
percent	ğŸ¦‹
greedy	ğŸ‘·ğŸ¼
rich	ğŸšš
sushi	ğŸšš
buds	ğŸšš
flag for algeria	ğŸšš
seeing	ğŸ“¬
pensive face	ğŸ“¬
concerned face	ğŸ’‘
july 17	ğŸ’‘
dollar sign	ğŸ’‘
wild pig	ğŸ‡¨ğŸ‡«
grinning face	ğŸ‡¨ğŸ‡«
flag for sudan	ğŸ‡µğŸ‡¸
sleuth	ğŸ‡µğŸ‡¸
regional indicator symbol letters dm	ğŸš§
dolls	ğŸš§
toilet sign	ğŸš§
quiet	ğŸš§
blowing wind	ğŸ‡±ğŸ‡¹
bawling	ğŸ‡±ğŸ‡¹
happy face	ğŸ‡±ğŸ‡¹
cute bear	ğŸš
shopping center	ğŸš
fruit	ğŸš
flag for sint maarten	ğŸ“™
i am a witness	ğŸ‘§ğŸ¿
punch	âœŠğŸ¾
green truck	ğŸ”‘
city	ğŸ“±
game	ğŸ“±
person with trash	ğŸ“±
family of two women with one girl	ğŸ“±
alien	ğŸ“±
greek	ğŸŒ†
legendary	ğŸŒ†
puzzled	ğŸŒ†
leaves	ğŸŒ†
stiletto	ğŸŒ†
lady cow	ğŸŒ†
gown	ğŸŒ†
japanese	ğŸŒ†
tears	ğŸŒ†
anguished face	ğŸŒ†
puppy paw prints	ğŸŒ†
playfulness	ğŸŒ†
santa	â™’
feats of strength	â™’
admission	â™’
flag for cuba	â™’
white bride with veil	â™’
woman	â™’
shaved ice	â™’
dessert	â™’
rodent	â™’
deeper brown girl	ğŸ‡¦ğŸ‡²
sign	ğŸ‡¦ğŸ‡²
mcdonalds fries	ğŸ¤¶
bathing	ğŸ¤¶
skull and crossbones	ğŸ••
deeper brown person with folded hands	ğŸ­
detective	ğŸ­
kids	ğŸ­
nintendo	ğŸ¯
zodiac	ğŸ¯
start	ğŸ¯
fortified	ğŸ¯
pina	ğŸ¯
snowing snowman	ğŸ¯
thunder cloud and rain	ğŸ¯
bear	ğŸ¯
thinking bubble	ğŸ
transportation	ğŸ
asia	ğŸ
growing heart	ğŸ
synagogue	ğŸ
puppy	ğŸ
smile	ğŸ
greek	ğŸ
thanksgiving turkey	ğŸ
regional indicator symbol letters dj	ğŸ
light brown nail polish	ğŸ
western	ğŸŒ™
emergency	ğŸŒ™
letters	ğŸŒ™
cat	ğŸŒ™
regional indicator symbol letters ve	ğŸŒ™
candy	ğŸŒ™
grandstand	ğŸŒ™
hands	ğŸŒ™
black raised fist	ğŸ‘ƒğŸ¿
megabyte	â˜£
jam	ğŸšµğŸ¾
wind bell	ğŸ¶
sleepy	ğŸ¶
zodiac	ğŸ¶
mask	ğŸ¶
outbox	ğŸ¶
open padlock	ğŸ¶
pakistani flag	ğŸ¶
baggage claim	ğŸ¶
admission tickets	ğŸŒª
horn	ğŸ‡¹ğŸ‡¨
keycap digit two	ğŸ‡³
rofl	ğŸ‘·ğŸ¿
bathroom	ğŸ’¨
whisky glass	ğŸ’¨
twenty quid note	ğŸ’¨
mad face	ğŸ’¨
knife weapon	ğŸ’¨
guardsman	ğŸ’¨
kissing lips	ğŸ§€
fruit	ğŸ§€
flag for libya	ğŸ‡©ğŸ‡¿
heavy minus sign	ğŸ‡©ğŸ‡¿
take	ğŸ‡©ğŸ‡¿
holding hands	ğŸ‘§ğŸ¾
moonface	ğŸ“Œ
beer	ğŸ“Œ
movie	â©
white white up pointing backhand index	âšª
ram	ğŸ”¤
smartphone	ğŸ”¤
football	ğŸ”¤
flag for guinea	ğŸ”¤
cow	â›±
person with pouting face	ğŸ¤¤
cow	ğŸ¤¤
annoyed	ğŸ˜
waste	ğŸ˜
interstate	ğŸ˜
transport	ğŸ˜
cancer	ğŸ˜
moon	ğŸ˜
numeric input	ğŸ˜
baby chicken	ğŸ˜
grandma	ğŸ˜
heart with ribbon	ğŸ˜
beamed pair of eighth notes	ğŸ™†ğŸ½
cute	ğŸ™
wheelchair symbol	ğŸ™
fruit	ğŸ³
run	ğŸ³
car	ğŸ³
shallow pan of food	ğŸ³
deciduous	ğŸ³
party	ğŸ³
black haircut	ğŸ³
protective	ğŸ³
nose	ğŸ³
wrap	ğŸ³
fruit	ğŸ³
olive toned white up pointing backhand index	ğŸ“
lock	ğŸ“
zodiac	ğŸ“
kimono	ğŸ“
tongue face	ğŸ“
astrology	ğŸ›‘
sad	ğŸ›‘
mountain bike	ğŸ‘‹ğŸ½
festivus miracle	ğŸš
flag for pitcairn islands	ğŸš
shopping	ğŸš
astonished	ğŸš
shining star	ğŸš¶ğŸ¿
carrot	ğŸ‘
red circle crossed	ğŸ‘
sunglasses	ğŸ‘
dress	ğŸ‘
ä¸­	ğŸ‘
regional indicator symbol letters kh	ğŸ‘
spiral bound book	ğŸ‘
pointing up	ğŸ‘
residence	ğŸ‘
thunderbolt	ğŸ‘
bicycle	ğŸ‘
lick	ğŸ‘
television	ğŸ‘
regional indicator symbol letters tr	ğŸ¥„
tie	ğŸ“
drop bear	ğŸ“
evergreen	ğŸ“
waning	ğŸ“
black nail polish	ğŸ“
shifty eyes	ğŸ£
aqua	ğŸ£
strawberry	ğŸ£
cat	ğŸ£
easter	ğŸ£
stars	ğŸ£
flag for estonia	ğŸ£
perspiration	ğŸ£
vibration mode	ğŸ£
european castle	ğŸ£
young	ğŸ£
rain	ğŸ¦
train	ğŸŒ¹
rock	ğŸŒ¹
dressing gown	ğŸŒ¹
reduce volume	ğŸŒ¹
digital camera	ğŸŒ¹
happy	ğŸŒ¹
travel	ğŸŒ¹
peace	ğŸŒ¹
www	ğŸŒ¹
haitian flag	ğŸ
stopwatch	ğŸ
face with ok gesture	ğŸ‡»ğŸ‡¨
leftwards arrow with hook	â™£ï¸
compassionate	â™£ï¸
input symbol for latin small letters	ğŸ‡©ğŸ‡²
flag for bolivia	ğŸ‡©ğŸ‡²
school	ğŸ‘‡ğŸ¾
sunrise	ğŸ¤“
dancing	ğŸ¤“
flag for new caledonia	ğŸ”²
clapping hands sign	ğŸ¦„
mother nature	ğŸ¦„
regional indicator symbol letters gq	âŒ
shame	âŒ
unity	âŒ
violin	ğŸ’ªğŸ¾
lovestruck	ğŸ™„
railway	ğŸ™„
flag for croatia	ğŸš²
day calendar	ğŸš²
telephone receiver	ğŸš²
spiral note pad	ğŸš²
red face	ğŸš²
grandpa	ğŸ³
astrology	ğŸ³
racing flag	ğŸ³
autumn	ğŸ³
french flag	ğŸ³
day dream	ğŸ³
verbal	ğŸ³
intelligence	ğŸ³
sparkle	ğŸ³
anticlockwise downwards and upwards open circle arrows	ğŸ³
rice	ğŸ³
love	ğŸ‡«ğŸ‡·
mahjong tile	ğŸ‡«ğŸ‡·
snowing	ğŸ‡«ğŸ‡·
snore	ğŸ‘ƒ
dove of peace	ğŸ‘ƒ
nanna	ğŸ‘ƒ
head massage	ğŸ‘ƒ
gold	ğŸ˜Ÿ
education	ğŸ˜Ÿ
star	ğŸ˜Ÿ
intoxicated	ğŸ˜Ÿ
surfing	ğŸ˜Ÿ
snowboarder	ğŸ˜Ÿ
new	ğŸ˜Ÿ
sos	ğŸ˜Ÿ
sign	ğŸ‡¦ğŸ‡¶
deeper brown ok hand sign	ğŸ¤–
wavy dash	ğŸ¤–
boom	ğŸ”µ
hairdresser	6âƒ£ï¸
stronghold	ğŸ‰
grinning	ğŸ‰
et	ğŸ‰
night	ğŸ‰
house building	â¬‡ï¸
white	âœ
party popper	âœ
frustration	ğŸ’”
flag for solomon islands	ğŸ’”
wings	ğŸ’”
european	ğŸ’”
1234	ğŸ’¹
traffic	â˜¸
nautilus	ğŸˆš
pain	ğŸˆš
medium black circle	ğŸ—»
showgirls	ğŸŸ
virgo	ğŸ‡®ğŸ‡²
paw prints	ğŸ‡®ğŸ‡²
smile	ğŸ™ŒğŸ»
nose	ğŸ‡¬ğŸ‡±
bus stop	5âƒ£ï¸
syrup	ğŸ‡°ğŸ‡¼
work	ğŸ‡°ğŸ‡¼
clock tower	ğŸ‘‰ğŸ»
fisted hand sign	ğŸš¡
ice	ğŸš¡
blue	ğŸš¡
man in suit	ğŸš¡
avatar	ğŸš¡
monkey covering eyes	ğŸš¡
agriculture	ğŸš¡
right triangle	ğŸš¡
deeper brown princess	ğŸš¡
person with ball	ğŸ‡³ğŸ‡¬
keycap digit four	ğŸ‡³ğŸ‡¬
city	ğŸ‡³ğŸ‡¬
ride	ğŸ–
sparkle	ğŸ–
zodiac	ğŸ–
grain	ğŸ–
surgical mask	ğŸ‘´
music	ğŸ‘´
skirt	ğŸ‘´
police	ğŸ‘´
light brown white right pointing backhand index	â†™ï¸
gas pump	ğŸ‘²ğŸ½
keycap digit six	â˜”
regional indicator symbol letters ne	â˜”
star	â˜”
green salad	â˜”
crocodile	â˜”
flag for cape verde	â†–ï¸
fort	ğŸ‡§ğŸ‡©
night	ğŸ‡§ğŸ‡©
running shirt	ğŸ‡¸ğŸ‡¨
outbox tray	ğŸ‡¸ğŸ‡¨
cock	ğŸ¤³
fruit	ğŸ•’
prince	ğŸš£ğŸ¿
oncoming bus	ğŸ‘¶ğŸ¾
smiley sun	ğŸ‘¨ğŸ¾
æœˆ	ğŸº
poultry leg	ğŸº
sick	ğŸº
purple devil	ğŸ‡¦ğŸ‡½
hugging	ğŸ‡¦ğŸ‡½
notice	ğŸ™‡ğŸ¿
izakaya lantern	ğŸ˜·
jazz hands	ğŸ˜·
flag for dominica	ğŸ˜·
olaf	ğŸ˜·
fortress	ğŸ˜·
indian camel	ğŸ˜·
sky	ğŸ˜·
zodiac	ğŸ˜·
menorah with nine branches	ğŸ˜·
sky	ğŸ˜·
regional indicator symbol letters be	ğŸ˜·
king	ğŸš
police officer	ğŸš
flag for cyprus	ğŸš
peace sign	ğŸš
gay	ğŸš
earth	ğŸš
celebration	ğŸš
pedestrian	ğŸš